State,County,Year,LabourForce,Employed,Unemployed
South Carolina,Abbeville,2016,10300,9734,566
Louisiana,Acadia Parish,2016,24508,22697,1811
Virginia,Accomack,2016,15783,15003,780
Idaho,Ada,2016,225548,218120,7428
Iowa,Adair,2016,4222,4097,125
Kentucky,Adair,2016,7085,6614,471
Missouri,Adair,2016,10388,9798,590
Oklahoma,Adair,2016,8160,7685,475
Colorado,Adams,2016,253398,244332,9066
Iowa,Adams,2016,2209,2152,57
Idaho,Adams,2016,1747,1626,121
Illinois,Adams,2016,32483,30936,1547
Indiana,Adams,2016,17037,16427,610
Mississippi,Adams,2016,11258,10331,927
North Dakota,Adams,2016,1132,1103,29
Nebraska,Adams,2016,16637,16116,521
Ohio,Adams,2016,10939,10112,827
Pennsylvania,Adams,2016,55378,53186,2192
Washington,Adams,2016,8700,8137,563
Wisconsin,Adams,2016,8296,7796,500
Vermont,Addison,2016,20855,20237,618
Puerto Rico,Adjuntas Municipio,2016,4470,3717,753
Puerto Rico,Aguada Municipio,2016,11907,10245,1662
Puerto Rico,Aguadilla Municipio,2016,14906,12689,2217
Puerto Rico,Aguas Buenas Municipio,2016,6787,5814,973
Puerto Rico,Aibonito Municipio,2016,6673,5680,993
South Carolina,Aiken,2016,74254,70528,3726
Minnesota,Aitkin,2016,7052,6558,494
Florida,Alachua,2016,132392,126746,5646
North Carolina,Alamance,2016,78943,75209,3734
California,Alameda,2016,831718,796037,35681
Colorado,Alamosa,2016,7962,7640,322
New York,Albany,2016,158435,152009,6426
Wyoming,Albany,2016,20960,20287,673
Virginia,Albemarle,2016,54381,52432,1949
Michigan,Alcona,2016,3827,3534,293
Mississippi,Alcorn,2016,15831,15012,819
Alaska,Aleutians East Borough,2016,2583,2514,69
Alaska,Aleutians West Census Area,2016,3974,3842,132
Illinois,Alexander,2016,2205,1999,206
North Carolina,Alexander,2016,17835,17078,757
Virginia,Alexandria city,2016,96248,93422,2826
Oklahoma,Alfalfa,2016,2969,2871,98
Michigan,Alger,2016,3263,2994,269
Iowa,Allamakee,2016,7648,7269,379
Michigan,Allegan,2016,61265,58880,2385
Maryland,Allegany,2016,32492,30460,2032
New York,Allegany,2016,20052,18786,1266
North Carolina,Alleghany,2016,4426,4183,243
Virginia,Alleghany,2016,6924,6568,356
Pennsylvania,Allegheny,2016,647300,613814,33486
Indiana,Allen,2016,180853,173132,7721
Kansas,Allen,2016,6432,6073,359
Kentucky,Allen,2016,8850,8466,384
Ohio,Allen,2016,48242,45808,2434
Louisiana,Allen Parish,2016,8899,8327,572
South Carolina,Allendale,2016,2666,2437,229
Michigan,Alpena,2016,13646,12834,812
California,Alpine,2016,553,518,35
California,Amador,2016,14522,13658,864
Virginia,Amelia,2016,6191,5925,266
Virginia,Amherst,2016,14972,14310,662
Mississippi,Amite,2016,4512,4182,330
Puerto Rico,Anasco Municipio,2016,8893,7749,1144
Alaska,Anchorage Borough/municipality,2016,155274,146720,8554
Kansas,Anderson,2016,4169,3991,178
Kentucky,Anderson,2016,11455,10991,464
South Carolina,Anderson,2016,89049,84947,4102
Tennessee,Anderson,2016,33547,31921,1626
Texas,Anderson,2016,23500,22484,1016
Missouri,Andrew,2016,10048,9674,374
Texas,Andrews,2016,8686,8277,409
Maine,Androscoggin,2016,55245,53266,1979
Texas,Angelina,2016,37048,34864,2184
Maryland,Anne Arundel,2016,304143,292511,11632
Minnesota,Anoka,2016,192557,185393,7164
North Carolina,Anson,2016,10660,10043,617
Nebraska,Antelope,2016,3589,3495,94
Michigan,Antrim,2016,10065,9354,711
Arizona,Apache,2016,20284,17966,2318
Iowa,Appanoose,2016,6142,5851,291
Georgia,Appling,2016,9174,8589,585
Virginia,Appomattox,2016,6988,6658,330
Texas,Aransas,2016,10234,9663,571
Colorado,Arapahoe,2016,340304,329761,10543
Texas,Archer,2016,4087,3911,176
Colorado,Archuleta,2016,6360,6151,209
Puerto Rico,Arecibo Municipio,2016,23997,20832,3165
Michigan,Arenac,2016,6119,5612,507
Arkansas,Arkansas,2016,9255,8940,315
Virginia,Arlington,2016,146178,142317,3861
Pennsylvania,Armstrong,2016,33078,30603,2475
Texas,Armstrong,2016,934,908,26
Maine,Aroostook,2016,31419,29714,1705
Puerto Rico,Arroyo Municipio,2016,5140,4187,953
Nebraska,Arthur,2016,227,214,13
Louisiana,Ascension Parish,2016,61982,58949,3033
North Carolina,Ashe,2016,12508,11909,599
Ohio,Ashland,2016,26250,24910,1340
Wisconsin,Ashland,2016,7967,7535,432
Arkansas,Ashley,2016,7940,7454,486
Ohio,Ashtabula,2016,44206,41494,2712
Washington,Asotin,2016,9944,9448,496
Louisiana,Assumption Parish,2016,9206,8433,773
Texas,Atascosa,2016,21012,19892,1120
Kansas,Atchison,2016,7038,6600,438
Missouri,Atchison,2016,2846,2716,130
Ohio,Athens,2016,28008,26205,1803
Georgia,Atkinson,2016,3971,3763,208
New Jersey,Atlantic,2016,122411,113320,9091
Oklahoma,Atoka,2016,5065,4733,332
Mississippi,Attala,2016,7018,6550,468
Missouri,Audrain,2016,11151,10677,474
Iowa,Audubon,2016,3267,3159,108
Ohio,Auglaize,2016,24610,23687,923
Virginia,Augusta,2016,36795,35436,1359
South Dakota,Aurora,2016,1521,1487,34
Texas,Austin,2016,14024,13278,746
Alabama,Autauga,2016,26031,24709,1322
North Carolina,Avery,2016,7576,7195,381
Louisiana,Avoyelles Parish,2016,15682,14574,1108
Colorado,Baca,2016,2091,2055,36
Georgia,Bacon,2016,4973,4713,260
Texas,Bailey,2016,2717,2598,119
Florida,Baker,2016,11397,10844,553
Georgia,Baker,2016,1180,1089,91
Oregon,Baker,2016,6951,6513,438
Alabama,Baldwin,2016,90895,86060,4835
Georgia,Baldwin,2016,17606,16401,1205
Kentucky,Ballard,2016,3643,3316,327
Maryland,Baltimore,2016,446180,425357,20823
Maryland,Baltimore city,2016,290265,271061,19204
South Carolina,Bamberg,2016,5326,4843,483
Texas,Bandera,2016,9499,9110,389
Georgia,Banks,2016,8801,8374,427
Nebraska,Banner,2016,416,402,14
Idaho,Bannock,2016,41147,39682,1465
Michigan,Baraga,2016,3219,2954,265
Kansas,Barber,2016,2524,2431,93
Alabama,Barbour,2016,8436,7736,700
West Virginia,Barbour,2016,6958,6484,474
Puerto Rico,Barceloneta Municipio,2016,5863,5034,829
North Dakota,Barnes,2016,5619,5440,179
Massachusetts,Barnstable,2016,111595,106122,5473
South Carolina,Barnwell,2016,8086,7487,599
Puerto Rico,Barranquitas Municipio,2016,7480,6521,959
Kentucky,Barren,2016,18854,17962,892
Wisconsin,Barron,2016,24389,23280,1109
Georgia,Barrow,2016,37638,35863,1775
Michigan,Barry,2016,30738,29508,1230
Missouri,Barry,2016,15217,14533,684
Indiana,Bartholomew,2016,44444,42938,1506
Kansas,Barton,2016,14008,13380,628
Missouri,Barton,2016,5328,5049,279
Georgia,Bartow,2016,48113,45649,2464
Texas,Bastrop,2016,39014,37557,1457
Missouri,Bates,2016,8169,7732,437
Kentucky,Bath,2016,4759,4406,353
Virginia,Bath,2016,2492,2399,93
Arkansas,Baxter,2016,16077,15387,690
Florida,Bay,2016,87761,83595,4166
Michigan,Bay,2016,51874,49042,2832
Puerto Rico,Bayamon Municipio,2016,66356,60399,5957
Wisconsin,Bayfield,2016,7547,7027,520
Texas,Baylor,2016,1605,1547,58
South Dakota,Beadle,2016,9411,9168,243
#N/A,Bear,ID,2016,2816,2687
North Carolina,Beaufort,2016,20307,19153,1154
South Carolina,Beaufort,2016,72630,69147,3483
Louisiana,Beauregard Parish,2016,15063,14151,912
Oklahoma,Beaver,2016,2889,2799,90
Pennsylvania,Beaver,2016,85293,80021,5272
Utah,Beaver,2016,3076,2924,152
Montana,Beaverhead,2016,5077,4909,168
Minnesota,Becker,2016,18621,17771,850
Oklahoma,Beckham,2016,11042,10249,793
Pennsylvania,Bedford,2016,24043,22639,1404
Tennessee,Bedford,2016,19752,18773,979
Virginia,Bedford,2016,37913,36349,1564
Texas,Bee,2016,10305,9531,774
New Hampshire,Belknap,2016,31386,30496,890
Kentucky,Bell,2016,8659,7859,800
Texas,Bell,2016,139445,133173,6272
Ohio,Belmont,2016,31000,28674,2326
Minnesota,Beltrami,2016,23757,22519,1238
Georgia,Ben Hill,2016,5538,5084,454
Idaho,Benewah,2016,4019,3781,238
South Dakota,Bennett,2016,1123,1079,44
Vermont,Bennington,2016,18449,17756,693
North Dakota,Benson,2016,2434,2336,98
Colorado,Bent,2016,1850,1793,57
Arkansas,Benton,2016,127720,124007,3713
Iowa,Benton,2016,13561,13071,490
Indiana,Benton,2016,4565,4372,193
Minnesota,Benton,2016,21850,20888,962
Missouri,Benton,2016,7268,6828,440
Mississippi,Benton,2016,3050,2846,204
Oregon,Benton,2016,46783,44947,1836
Tennessee,Benton,2016,6714,6237,477
Washington,Benton,2016,94130,88182,5948
Michigan,Benzie,2016,8835,8254,581
New Jersey,Bergen,2016,478906,458863,20043
South Carolina,Berkeley,2016,97155,92694,4461
West Virginia,Berkeley,2016,54066,51923,2143
Pennsylvania,Berks,2016,213140,202560,10580
Massachusetts,Berkshire,2016,64353,61454,2899
New Mexico,Bernalillo,2016,326722,307963,18759
Georgia,Berrien,2016,7209,6767,442
Michigan,Berrien,2016,73776,70115,3661
North Carolina,Bertie,2016,8436,7879,557
Alaska,Bethel Census Area,2016,7237,6207,1030
Texas,Bexar,2016,905115,871260,33855
Alabama,Bibb,2016,8644,8088,556
Georgia,Bibb,2016,68537,64465,4072
Louisiana,Bienville Parish,2016,5664,5233,431
Montana,Big Horn,2016,5540,5139,401
Wyoming,Big Horn,2016,5536,5260,276
Minnesota,Big Stone,2016,2713,2583,130
North Dakota,Billings,2016,438,425,13
Idaho,Bingham,2016,22830,22027,803
Iowa,Black Hawk,2016,69082,65879,3203
Indiana,Blackford,2016,5336,5050,286
North Carolina,Bladen,2016,14569,13564,1005
Idaho,Blaine,2016,11867,11493,374
Montana,Blaine,2016,2372,2264,108
Nebraska,Blaine,2016,264,253,11
Oklahoma,Blaine,2016,4395,4233,162
Pennsylvania,Blair,2016,60828,57624,3204
Texas,Blanco,2016,5932,5749,183
Virginia,Bland,2016,2736,2591,145
Georgia,Bleckley,2016,4495,4139,356
Tennessee,Bledsoe,2016,4306,4007,299
Alabama,Blount,2016,24684,23358,1326
Tennessee,Blount,2016,60618,57977,2641
Minnesota,Blue Earth,2016,39754,38480,1274
Idaho,Boise,2016,3102,2938,164
Mississippi,Bolivar,2016,13411,12444,967
Missouri,Bollinger,2016,5469,5182,287
South Dakota,Bon Homme,2016,2945,2865,80
Illinois,Bond,2016,7878,7475,403
Idaho,Bonner,2016,18921,17895,1026
Idaho,Bonneville,2016,52476,50808,1668
Arkansas,Boone,2016,15904,15321,583
Iowa,Boone,2016,15072,14651,421
Illinois,Boone,2016,26325,24648,1677
Indiana,Boone,2016,34853,33677,1176
Kentucky,Boone,2016,67249,64670,2579
Missouri,Boone,2016,98313,95073,3240
Nebraska,Boone,2016,3000,2921,79
West Virginia,Boone,2016,7986,7258,728
Texas,Borden,2016,366,353,13
Texas,Bosque,2016,8185,7833,352
Louisiana,Bossier Parish,2016,57579,54516,3063
Virginia,Botetourt,2016,17326,16691,635
North Dakota,Bottineau,2016,3227,3077,150
Colorado,Boulder,2016,180697,175874,4823
Idaho,Boundary,2016,5114,4846,268
Kansas,Bourbon,2016,7120,6774,346
Kentucky,Bourbon,2016,9877,9404,473
Texas,Bowie,2016,39610,37749,1861
North Dakota,Bowman,2016,1835,1796,39
Nebraska,Box Butte,2016,5638,5435,203
Utah,Box Elder,2016,24683,23821,862
Kentucky,Boyd,2016,18548,17036,1512
Nebraska,Boyd,2016,1098,1065,33
Kentucky,Boyle,2016,12310,11696,614
Kentucky,Bracken,2016,3831,3599,232
Florida,Bradford,2016,10841,10381,460
Pennsylvania,Bradford,2016,30163,28196,1967
Arkansas,Bradley,2016,4477,4252,225
Tennessee,Bradley,2016,49945,47725,2220
Michigan,Branch,2016,19097,18177,920
Georgia,Brantley,2016,7085,6609,476
West Virginia,Braxton,2016,5490,5008,482
Texas,Brazoria,2016,169795,161001,8794
Texas,Brazos,2016,111251,107409,3842
Kentucky,Breathitt,2016,3747,3376,371
Kentucky,Breckinridge,2016,7737,7246,491
Iowa,Bremer,2016,13868,13372,496
Florida,Brevard,2016,262074,248726,13348
Texas,Brewster,2016,3960,3811,149
Texas,Briscoe,2016,548,524,24
Massachusetts,Bristol,2016,290659,276376,14283
Rhode Island,Bristol,2016,26132,24924,1208
Alaska,Bristol Bay Borough,2016,413,384,29
Virginia,Bristol city,2016,7439,7058,381
Montana,Broadwater,2016,2553,2428,125
New York,Bronx,2016,607295,563965,43330
West Virginia,Brooke,2016,9976,9272,704
South Dakota,Brookings,2016,18886,18369,517
Georgia,Brooks,2016,6999,6632,367
Texas,Brooks,2016,2438,2151,287
New York,Broome,2016,85851,81196,4655
Colorado,Broomfield,2016,36747,35684,1063
Florida,Broward,2016,1002237,957296,44941
Illinois,Brown,2016,2856,2760,96
Indiana,Brown,2016,7521,7219,302
Kansas,Brown,2016,5159,4972,187
Minnesota,Brown,2016,14570,13960,610
Nebraska,Brown,2016,1378,1328,50
Ohio,Brown,2016,19485,18350,1135
South Dakota,Brown,2016,21087,20524,563
Texas,Brown,2016,16164,15463,701
Wisconsin,Brown,2016,141375,136269,5106
South Dakota,Brule,2016,2471,2408,63
North Carolina,Brunswick,2016,49705,46504,3201
Virginia,Brunswick,2016,6203,5830,373
Georgia,Bryan,2016,16901,16079,822
Oklahoma,Bryan,2016,19525,18686,839
Iowa,Buchanan,2016,11171,10711,460
Missouri,Buchanan,2016,46769,44857,1912
Virginia,Buchanan,2016,6854,6113,741
Virginia,Buckingham,2016,6259,5916,343
Pennsylvania,Bucks,2016,340728,325030,15698
Iowa,Buena Vista,2016,11481,11076,405
Virginia,Buena Vista city,2016,3272,3104,168
Nebraska,Buffalo,2016,27185,26504,681
South Dakota,Buffalo,2016,726,666,60
Wisconsin,Buffalo,2016,6583,6289,294
Kentucky,Bullitt,2016,40517,38822,1695
Georgia,Bulloch,2016,35907,33852,2055
Alabama,Bullock,2016,4844,4514,330
North Carolina,Buncombe,2016,134374,129188,5186
Illinois,Bureau,2016,17374,16324,1050
Georgia,Burke,2016,9227,8516,711
North Carolina,Burke,2016,39858,37921,1937
North Dakota,Burke,2016,1145,1093,52
North Dakota,Burleigh,2016,50602,49297,1305
Texas,Burleson,2016,7872,7507,365
New Jersey,Burlington,2016,229949,219677,10272
Texas,Burnet,2016,21986,21226,760
Wisconsin,Burnett,2016,7188,6757,431
Nebraska,Burt,2016,3542,3412,130
Alabama,Butler,2016,9229,8593,636
Iowa,Butler,2016,8006,7658,348
Kansas,Butler,2016,32159,30816,1343
Kentucky,Butler,2016,5160,4877,283
Missouri,Butler,2016,18826,17748,1078
Nebraska,Butler,2016,4620,4472,148
Ohio,Butler,2016,189364,180784,8580
Pennsylvania,Butler,2016,98572,93599,4973
California,Butte,2016,101627,94909,6718
Idaho,Butte,2016,1295,1242,53
South Dakota,Butte,2016,5047,4873,174
Georgia,Butts,2016,10361,9778,583
North Carolina,Cabarrus,2016,101184,96569,4615
West Virginia,Cabell,2016,41199,39214,1985
Puerto Rico,Cabo Rojo Municipio,2016,14168,12405,1763
Utah,Cache,2016,61232,59361,1871
Oklahoma,Caddo,2016,11934,11302,632
Louisiana,Caddo Parish,2016,107031,99951,7080
Puerto Rico,Caguas Municipio,2016,48264,43281,4983
California,Calaveras,2016,20794,19615,1179
Louisiana,Calcasieu Parish,2016,102869,97954,4915
Kentucky,Caldwell,2016,5354,5061,293
Missouri,Caldwell,2016,4481,4270,211
North Carolina,Caldwell,2016,35899,34039,1860
Texas,Caldwell,2016,17936,17161,775
Louisiana,Caldwell Parish,2016,3982,3678,304
Vermont,Caledonia,2016,14901,14284,617
Alabama,Calhoun,2016,46013,43016,2997
Arkansas,Calhoun,2016,2389,2279,110
Florida,Calhoun,2016,4976,4692,284
Georgia,Calhoun,2016,2160,2038,122
Iowa,Calhoun,2016,4509,4339,170
Illinois,Calhoun,2016,2374,2227,147
Michigan,Calhoun,2016,64390,61295,3095
Mississippi,Calhoun,2016,6189,5859,330
South Carolina,Calhoun,2016,6913,6484,429
Texas,Calhoun,2016,10771,10171,600
West Virginia,Calhoun,2016,2621,2284,337
Texas,Callahan,2016,5804,5557,247
Missouri,Callaway,2016,21860,20962,898
Kentucky,Calloway,2016,18688,17837,851
Wisconsin,Calumet,2016,27761,26871,890
Maryland,Calvert,2016,48896,46998,1898
Idaho,Camas,2016,659,635,24
Pennsylvania,Cambria,2016,61318,57163,4155
Georgia,Camden,2016,20318,19149,1169
Missouri,Camden,2016,18751,17664,1087
North Carolina,Camden,2016,4659,4419,240
New Jersey,Camden,2016,252368,238479,13889
Pennsylvania,Cameron,2016,2231,2067,164
Texas,Cameron,2016,165955,154064,11891
Louisiana,Cameron Parish,2016,3817,3650,167
Texas,Camp,2016,5059,4714,345
Kentucky,Campbell,2016,48706,46831,1875
South Dakota,Campbell,2016,850,825,25
Tennessee,Campbell,2016,14680,13667,1013
Virginia,Campbell,2016,25906,24746,1160
Wyoming,Campbell,2016,24396,22635,1761
Puerto Rico,Camuy Municipio,2016,9505,8330,1175
Oklahoma,Canadian,2016,69467,66703,2764
Georgia,Candler,2016,5063,4821,242
Tennessee,Cannon,2016,5999,5722,277
Puerto Rico,Canovanas Municipio,2016,16274,14404,1870
Idaho,Canyon,2016,93783,89703,4080
Missouri,Cape Girardeau,2016,40824,39053,1771
New Jersey,Cape May,2016,46601,42016,4585
Montana,Carbon,2016,5426,5212,214
Pennsylvania,Carbon,2016,31552,29674,1878
Utah,Carbon,2016,8334,7838,496
Wyoming,Carbon,2016,8358,7965,393
Idaho,Caribou,2016,3801,3664,137
Kentucky,Carlisle,2016,2564,2397,167
Minnesota,Carlton,2016,17800,16859,941
Puerto Rico,Carolina Municipio,2016,62164,56791,5373
Maryland,Caroline,2016,17704,16855,849
Virginia,Caroline,2016,14839,14170,669
Arkansas,Carroll,2016,12850,12393,457
Georgia,Carroll,2016,53456,50247,3209
Iowa,Carroll,2016,11247,10958,289
Illinois,Carroll,2016,7865,7420,445
Indiana,Carroll,2016,10108,9679,429
Kentucky,Carroll,2016,5182,4924,258
Maryland,Carroll,2016,93288,89884,3404
Missouri,Carroll,2016,4776,4519,257
Mississippi,Carroll,2016,3566,3308,258
New Hampshire,Carroll,2016,23672,22974,698
Ohio,Carroll,2016,13432,12508,924
Tennessee,Carroll,2016,11979,11176,803
Virginia,Carroll,2016,12946,12274,672
Texas,Carson,2016,3096,2995,101
Nevada,Carson City,2016,24721,23222,1499
Kentucky,Carter,2016,9943,8888,1055
Missouri,Carter,2016,2547,2366,181
Montana,Carter,2016,697,678,19
Oklahoma,Carter,2016,22738,21563,1175
Tennessee,Carter,2016,23584,22255,1329
North Carolina,Carteret,2016,31574,29947,1627
Minnesota,Carver,2016,56518,54657,1861
Montana,Cascade,2016,37838,36336,1502
Kentucky,Casey,2016,6689,6363,326
Iowa,Cass,2016,7244,7007,237
Illinois,Cass,2016,6213,5866,347
Indiana,Cass,2016,18047,17209,838
Michigan,Cass,2016,24334,23194,1140
Minnesota,Cass,2016,14203,13237,966
Missouri,Cass,2016,54599,52331,2268
North Dakota,Cass,2016,100165,97926,2239
Nebraska,Cass,2016,13128,12687,441
Texas,Cass,2016,12264,11384,880
Idaho,Cassia,2016,11610,11265,345
Texas,Castro,2016,3494,3387,107
North Carolina,Caswell,2016,9690,9164,526
Louisiana,Catahoula Parish,2016,3423,3105,318
Puerto Rico,Catano Municipio,2016,7912,7119,793
North Carolina,Catawba,2016,76890,73255,3635
Georgia,Catoosa,2016,32121,30569,1552
New Mexico,Catron,2016,1204,1108,96
New York,Cattaraugus,2016,34849,32768,2081
North Dakota,Cavalier,2016,2115,2059,56
Puerto Rico,Cayey Municipio,2016,16220,14480,1740
New York,Cayuga,2016,36691,34836,1855
Maryland,Cecil,2016,52752,49984,2768
Iowa,Cedar,2016,10828,10468,360
Missouri,Cedar,2016,5806,5516,290
Nebraska,Cedar,2016,4564,4448,116
Puerto Rico,Ceiba Municipio,2016,3798,3301,497
Pennsylvania,Centre,2016,78909,75622,3287
Iowa,Cerro Gordo,2016,23053,22224,829
Colorado,Chaffee,2016,8834,8600,234
Alabama,Chambers,2016,15043,14225,818
Texas,Chambers,2016,18204,17098,1106
Illinois,Champaign,2016,107398,102018,5380
Ohio,Champaign,2016,19874,18974,900
Missouri,Chariton,2016,3862,3694,168
Maryland,Charles,2016,84078,80496,3582
Virginia,Charles City,2016,3716,3545,171
South Dakota,Charles Mix,2016,3888,3764,124
South Carolina,Charleston,2016,202083,193793,8290
Michigan,Charlevoix,2016,13053,12330,723
Florida,Charlotte,2016,69161,65493,3668
Virginia,Charlotte,2016,5246,4981,265
Virginia,Charlottesville city,2016,24844,23997,847
Georgia,Charlton,2016,4733,4466,267
Kansas,Chase,2016,1405,1356,49
Nebraska,Chase,2016,2289,2242,47
Georgia,Chatham,2016,135862,128743,7119
North Carolina,Chatham,2016,34527,33065,1462
Georgia,Chattahoochee,2016,2055,1885,170
Georgia,Chattooga,2016,10419,9762,657
Kansas,Chautauqua,2016,1539,1459,80
New York,Chautauqua,2016,56113,52857,3256
New Mexico,Chaves,2016,28031,26172,1859
Tennessee,Cheatham,2016,20188,19387,801
Michigan,Cheboygan,2016,10813,9795,1018
Washington,Chelan,2016,43215,40734,2481
New York,Chemung,2016,36202,34131,2071
New York,Chenango,2016,22829,21673,1156
Alabama,Cherokee,2016,11382,10808,574
Georgia,Cherokee,2016,125693,120346,5347
Iowa,Cherokee,2016,6303,6074,229
Kansas,Cherokee,2016,10278,9822,456
North Carolina,Cherokee,2016,11146,10514,632
Oklahoma,Cherokee,2016,19302,18242,1060
South Carolina,Cherokee,2016,23572,22159,1413
Texas,Cherokee,2016,21190,20115,1075
Nebraska,Cherry,2016,3467,3389,78
Virginia,Chesapeake city,2016,117782,112696,5086
New Hampshire,Cheshire,2016,41402,40269,1133
Pennsylvania,Chester,2016,280252,269412,10840
South Carolina,Chester,2016,13415,12446,969
Tennessee,Chester,2016,8415,7997,418
South Carolina,Chesterfield,2016,21670,20585,1085
Virginia,Chesterfield,2016,180485,173447,7038
Colorado,Cheyenne,2016,1080,1056,24
Kansas,Cheyenne,2016,1342,1305,37
Nebraska,Cheyenne,2016,5445,5292,153
Iowa,Chickasaw,2016,6408,6124,284
Mississippi,Chickasaw,2016,7097,6633,464
Arkansas,Chicot,2016,3577,3342,235
Texas,Childress,2016,2958,2870,88
Alabama,Chilton,2016,19266,18213,1053
Michigan,Chippewa,2016,16383,15126,1257
Minnesota,Chippewa,2016,6989,6675,314
Wisconsin,Chippewa,2016,33414,31993,1421
Minnesota,Chisago,2016,29245,27983,1262
Vermont,Chittenden,2016,95230,92854,2376
Alabama,Choctaw,2016,4344,3976,368
Mississippi,Choctaw,2016,3729,3519,210
Oklahoma,Choctaw,2016,5760,5321,439
Montana,Chouteau,2016,2516,2422,94
North Carolina,Chowan,2016,5602,5244,358
Illinois,Christian,2016,15291,14315,976
Kentucky,Christian,2016,24890,23351,1539
Missouri,Christian,2016,43426,41721,1705
Nevada,Churchill,2016,10385,9810,575
Puerto Rico,Ciales Municipio,2016,3839,3220,619
New Mexico,Cibola,2016,9300,8546,754
Puerto Rico,Cidra Municipio,2016,15580,13986,1594
Oklahoma,Cimarron,2016,1417,1382,35
Florida,Citrus,2016,47749,44552,3197
Oregon,Clackamas,2016,212633,203367,9266
Mississippi,Claiborne,2016,3093,2743,350
Tennessee,Claiborne,2016,12652,11867,785
Louisiana,Claiborne Parish,2016,5950,5553,397
Washington,Clallam,2016,27270,25193,2077
Michigan,Clare,2016,11951,11077,874
South Carolina,Clarendon,2016,12741,11888,853
Pennsylvania,Clarion,2016,18020,16913,1107
Arkansas,Clark,2016,9557,9144,413
Idaho,Clark,2016,394,381,13
Illinois,Clark,2016,8162,7687,475
Indiana,Clark,2016,60529,58008,2521
Kansas,Clark,2016,1115,1084,31
Kentucky,Clark,2016,17018,16194,824
Missouri,Clark,2016,3375,3127,248
Nevada,Clark,2016,1048544,987517,61027
Ohio,Clark,2016,63553,60203,3350
South Dakota,Clark,2016,1920,1845,75
Washington,Clark,2016,220404,206972,13432
Wisconsin,Clark,2016,17558,16873,685
Alabama,Clarke,2016,7985,7121,864
Georgia,Clarke,2016,58666,55434,3232
Iowa,Clarke,2016,4817,4655,162
Mississippi,Clarke,2016,6080,5670,410
Virginia,Clarke,2016,7424,7156,268
Oregon,Clatsop,2016,19017,18120,897
Alabama,Clay,2016,5648,5314,334
Arkansas,Clay,2016,6028,5688,340
Florida,Clay,2016,100841,96324,4517
Georgia,Clay,2016,882,790,92
Iowa,Clay,2016,8695,8360,335
Illinois,Clay,2016,6705,6247,458
Indiana,Clay,2016,12384,11806,578
Kansas,Clay,2016,4030,3866,164
Kentucky,Clay,2016,5454,4898,556
Minnesota,Clay,2016,35734,34508,1226
Missouri,Clay,2016,134218,128981,5237
Mississippi,Clay,2016,8024,7375,649
North Carolina,Clay,2016,4051,3830,221
Nebraska,Clay,2016,3318,3215,103
South Dakota,Clay,2016,6986,6777,209
Tennessee,Clay,2016,3031,2833,198
Texas,Clay,2016,4793,4584,209
West Virginia,Clay,2016,3258,2920,338
Georgia,Clayton,2016,130556,121941,8615
Iowa,Clayton,2016,10273,9837,436
Colorado,Clear Creek,2016,5681,5500,181
Pennsylvania,Clearfield,2016,36293,33655,2638
Idaho,Clearwater,2016,3055,2832,223
Minnesota,Clearwater,2016,4731,4278,453
Alabama,Cleburne,2016,5810,5464,346
Arkansas,Cleburne,2016,9469,8907,562
Ohio,Clermont,2016,103866,99226,4640
Arkansas,Cleveland,2016,3338,3188,150
North Carolina,Cleveland,2016,46815,44259,2556
Oklahoma,Cleveland,2016,139263,133954,5309
Georgia,Clinch,2016,2765,2595,170
Iowa,Clinton,2016,23751,22578,1173
Illinois,Clinton,2016,20450,19537,913
Indiana,Clinton,2016,17150,16484,666
Kentucky,Clinton,2016,3750,3466,284
Michigan,Clinton,2016,40488,38993,1495
Missouri,Clinton,2016,11029,10563,466
New York,Clinton,2016,35795,33877,1918
Ohio,Clinton,2016,17163,16158,1005
Pennsylvania,Clinton,2016,18547,17238,1309
Kansas,Cloud,2016,4252,4077,175
Mississippi,Coahoma,2016,9222,8424,798
Oklahoma,Coal,2016,2323,2153,170
Puerto Rico,Coamo Municipio,2016,10868,8903,1965
Georgia,Cobb,2016,409444,390646,18798
Arizona,Cochise,2016,49528,46452,3076
Texas,Cochran,2016,1174,1114,60
Tennessee,Cocke,2016,14398,13491,907
Arizona,Coconino,2016,74081,69639,4442
South Dakota,Codington,2016,15205,14737,468
Alabama,Coffee,2016,20684,19474,1210
Georgia,Coffee,2016,18057,17008,1049
Tennessee,Coffee,2016,24364,23219,1145
Kansas,Coffey,2016,4278,4013,265
Texas,Coke,2016,1421,1362,59
Alabama,Colbert,2016,23548,21918,1630
Missouri,Cole,2016,39488,38081,1407
Texas,Coleman,2016,3064,2886,178
Illinois,Coles,2016,24523,23075,1448
Nebraska,Colfax,2016,5544,5387,157
New Mexico,Colfax,2016,5828,5482,346
South Carolina,Colleton,2016,16783,15841,942
Florida,Collier,2016,168898,161045,7853
Texas,Collin,2016,512827,494723,18104
Texas,Collingsworth,2016,1215,1173,42
Virginia,Colonial Heights city,2016,8700,8306,394
Texas,Colorado,2016,9790,9329,461
Georgia,Colquitt,2016,21065,19959,1106
Arkansas,Columbia,2016,9281,8753,528
Florida,Columbia,2016,29705,28263,1442
Georgia,Columbia,2016,70932,67640,3292
New York,Columbia,2016,31460,30301,1159
Oregon,Columbia,2016,23612,22171,1441
Pennsylvania,Columbia,2016,33883,32012,1871
Washington,Columbia,2016,1716,1604,112
Wisconsin,Columbia,2016,31623,30485,1138
Ohio,Columbiana,2016,48366,45115,3251
North Carolina,Columbus,2016,22596,21149,1447
California,Colusa,2016,10901,9205,1696
Texas,Comal,2016,65468,63103,2365
Kansas,Comanche,2016,970,940,30
Oklahoma,Comanche,2016,49487,47211,2276
Texas,Comanche,2016,5356,5126,230
Puerto Rico,Comerio Municipio,2016,5072,4389,683
Texas,Concho,2016,1331,1286,45
Louisiana,Concordia Parish,2016,7250,6651,599
Alabama,Conecuh,2016,4567,4184,383
Colorado,Conejos,2016,3768,3585,183
California,Contra Costa,2016,553145,528400,24745
Wyoming,Converse,2016,7873,7381,492
Arkansas,Conway,2016,8439,7958,481
Georgia,Cook,2016,7511,7105,406
Illinois,Cook,2016,2660740,2500024,160716
Minnesota,Cook,2016,3104,2964,140
Texas,Cooke,2016,18907,18158,749
Missouri,Cooper,2016,7494,7125,369
New Hampshire,Coos,2016,14642,14090,552
Oregon,Coos,2016,26434,24745,1689
Alabama,Coosa,2016,4399,4137,262
Mississippi,Copiah,2016,11286,10553,733
Puerto Rico,Corozal Municipio,2016,9250,8114,1136
South Dakota,Corson,2016,1454,1389,65
New York,Cortland,2016,22982,21673,1309
Texas,Coryell,2016,24407,23269,1138
Ohio,Coshocton,2016,14989,13920,1069
Colorado,Costilla,2016,1727,1644,83
Texas,Cottle,2016,525,498,27
Oklahoma,Cotton,2016,2892,2754,138
Minnesota,Cottonwood,2016,5551,5154,397
Alabama,Covington,2016,15556,14509,1047
Mississippi,Covington,2016,8161,7719,442
Virginia,Covington city,2016,2380,2239,141
Georgia,Coweta,2016,70287,66795,3492
Kansas,Cowley,2016,16891,16143,748
Washington,Cowlitz,2016,44769,41559,3210
Oklahoma,Craig,2016,6258,5956,302
Virginia,Craig,2016,2347,2234,113
Arkansas,Craighead,2016,52147,50456,1691
Texas,Crane,2016,1705,1559,146
North Carolina,Craven,2016,41759,39576,2183
Arkansas,Crawford,2016,26907,25860,1047
Georgia,Crawford,2016,5668,5334,334
Iowa,Crawford,2016,8414,7954,460
Illinois,Crawford,2016,9026,8463,563
Indiana,Crawford,2016,4999,4717,282
Kansas,Crawford,2016,18894,17984,910
Michigan,Crawford,2016,5365,4959,406
Missouri,Crawford,2016,10846,10266,580
Ohio,Crawford,2016,19163,18001,1162
Pennsylvania,Crawford,2016,40485,38059,2426
Wisconsin,Crawford,2016,7934,7547,387
Oklahoma,Creek,2016,31526,29697,1829
Alabama,Crenshaw,2016,6480,6101,379
Georgia,Crisp,2016,9174,8621,553
Arkansas,Crittenden,2016,21573,20600,973
Kentucky,Crittenden,2016,4022,3809,213
Tennessee,Crockett,2016,6861,6503,358
Texas,Crockett,2016,1735,1605,130
Oregon,Crook,2016,9341,8693,648
Wyoming,Crook,2016,3737,3565,172
Texas,Crosby,2016,2620,2506,114
Arkansas,Cross,2016,7871,7523,348
Minnesota,Crow Wing,2016,31944,30322,1622
Colorado,Crowley,2016,1421,1371,50
Texas,Culberson,2016,1000,959,41
Puerto Rico,Culebra Municipio,2016,896,866,30
Alabama,Cullman,2016,38064,36179,1885
Virginia,Culpeper,2016,23416,22499,917
Illinois,Cumberland,2016,5981,5670,311
Kentucky,Cumberland,2016,2890,2724,166
Maine,Cumberland,2016,161698,156997,4701
North Carolina,Cumberland,2016,127339,119205,8134
New Jersey,Cumberland,2016,66246,61285,4961
Pennsylvania,Cumberland,2016,130077,124806,5271
Tennessee,Cumberland,2016,23475,22088,1387
Virginia,Cumberland,2016,4598,4384,214
Nebraska,Cuming,2016,4711,4575,136
North Carolina,Currituck,2016,13153,12487,666
New Mexico,Curry,2016,21969,20872,1097
Oregon,Curry,2016,9043,8432,611
Colorado,Custer,2016,2016,1953,63
Idaho,Custer,2016,2144,2035,109
Montana,Custer,2016,6246,6026,220
Nebraska,Custer,2016,6345,6196,149
Oklahoma,Custer,2016,15210,14519,691
South Dakota,Custer,2016,3993,3833,160
Ohio,Cuyahoga,2016,617505,583926,33579
Georgia,Dade,2016,8004,7600,404
Missouri,Dade,2016,3591,3431,160
Utah,Daggett,2016,463,439,24
Minnesota,Dakota,2016,235892,227902,7990
Nebraska,Dakota,2016,10895,10443,452
Alabama,Dale,2016,20043,18888,1155
Texas,Dallam,2016,3998,3909,89
Alabama,Dallas,2016,15480,14059,1421
Arkansas,Dallas,2016,2977,2833,144
Iowa,Dallas,2016,45693,44488,1205
Missouri,Dallas,2016,6967,6584,383
Texas,Dallas,2016,1298058,1245964,52094
Wisconsin,Dane,2016,318231,309163,9068
Montana,Daniels,2016,936,912,24
Virginia,Danville city,2016,19085,17916,1169
North Carolina,Dare,2016,20004,18654,1350
Ohio,Darke,2016,26364,25272,1092
South Carolina,Darlington,2016,29960,28087,1873
Pennsylvania,Dauphin,2016,142071,135314,6757
North Carolina,Davidson,2016,79516,75690,3826
Tennessee,Davidson,2016,372624,359204,13420
North Carolina,Davie,2016,20172,19265,907
Indiana,Daviess,2016,15972,15407,565
Kentucky,Daviess,2016,46674,44577,2097
Missouri,Daviess,2016,4122,3963,159
Iowa,Davis,2016,4278,4096,182
Utah,Davis,2016,164341,159150,5191
South Dakota,Davison,2016,11237,10968,269
Nebraska,Dawes,2016,5208,5054,154
Georgia,Dawson,2016,11313,10784,529
Montana,Dawson,2016,4608,4431,177
Nebraska,Dawson,2016,12949,12566,383
Texas,Dawson,2016,4638,4406,232
South Dakota,Day,2016,2858,2737,121
New Mexico,De Baca,2016,833,794,39
Louisiana,De Soto Parish,2016,10888,10088,800
Illinois,De Witt,2016,7941,7489,452
Texas,Deaf Smith,2016,8606,8338,268
Indiana,Dearborn,2016,25596,24390,1206
Georgia,Decatur,2016,11455,10694,761
Iowa,Decatur,2016,4393,4252,141
Indiana,Decatur,2016,14553,14035,518
Kansas,Decatur,2016,1291,1240,51
Tennessee,Decatur,2016,4644,4325,319
Montana,Deer Lodge,2016,5304,5103,201
Ohio,Defiance,2016,18373,17461,912
Alabama,DeKalb,2016,29355,27582,1773
Georgia,DeKalb,2016,382087,361505,20582
Illinois,DeKalb,2016,55182,52231,2951
Indiana,DeKalb,2016,22232,21361,871
Missouri,DeKalb,2016,5092,4869,223
Tennessee,DeKalb,2016,7520,7103,417
California,Del Norte,2016,9753,9019,734
Iowa,Delaware,2016,10698,10327,371
Indiana,Delaware,2016,55079,52254,2825
New York,Delaware,2016,19220,18159,1061
Ohio,Delaware,2016,104813,101003,3810
Oklahoma,Delaware,2016,17984,17105,879
Pennsylvania,Delaware,2016,294104,279800,14304
Colorado,Delta,2016,13949,13263,686
Michigan,Delta,2016,17114,15992,1122
Texas,Delta,2016,2606,2507,99
Alaska,Denali Borough,2016,1093,994,99
Missouri,Dent,2016,6213,5878,335
Texas,Denton,2016,451787,436317,15470
Colorado,Denver,2016,384721,372773,11948
Iowa,Des Moines,2016,19986,18998,988
Oregon,Deschutes,2016,89853,85483,4370
Arkansas,Desha,2016,5437,5141,296
Florida,DeSoto,2016,13447,12741,706
Mississippi,DeSoto,2016,87344,83679,3665
Nebraska,Deuel,2016,1059,1032,27
South Dakota,Deuel,2016,2239,2130,109
Oklahoma,Dewey,2016,2677,2569,108
South Dakota,Dewey,2016,2251,2049,202
Texas,DeWitt,2016,9495,8977,518
Texas,Dickens,2016,691,657,34
Virginia,Dickenson,2016,4570,4112,458
North Dakota,Dickey,2016,2545,2496,49
Iowa,Dickinson,2016,10273,9831,442
Kansas,Dickinson,2016,9157,8752,405
Michigan,Dickinson,2016,12501,11852,649
Tennessee,Dickson,2016,24696,23623,1073
Alaska,Dillingham Census Area,2016,2075,1875,200
South Carolina,Dillon,2016,12708,11845,863
Texas,Dimmit,2016,6236,5792,444
Virginia,Dinwiddie,2016,13428,12767,661
North Dakota,Divide,2016,1683,1639,44
Florida,Dixie,2016,5640,5334,306
Nebraska,Dixon,2016,3065,2964,101
West Virginia,Doddridge,2016,3780,3584,196
Georgia,Dodge,2016,7004,6495,509
Minnesota,Dodge,2016,11596,11166,430
Nebraska,Dodge,2016,19107,18521,586
Wisconsin,Dodge,2016,47942,46196,1746
Colorado,Dolores,2016,1071,1029,42
New Mexico,Dona Ana,2016,95598,88827,6771
Kansas,Doniphan,2016,4269,4104,165
Texas,Donley,2016,1556,1493,63
Georgia,Dooly,2016,4942,4656,286
Wisconsin,Door,2016,15530,14761,769
Puerto Rico,Dorado Municipio,2016,12924,11882,1042
Maryland,Dorchester,2016,15926,14933,993
South Carolina,Dorchester,2016,73287,69918,3369
Georgia,Dougherty,2016,38098,35492,2606
Colorado,Douglas,2016,177371,172638,4733
Georgia,Douglas,2016,70108,66215,3893
Illinois,Douglas,2016,10282,9797,485
Kansas,Douglas,2016,65198,62893,2305
Minnesota,Douglas,2016,20299,19593,706
Missouri,Douglas,2016,5089,4780,309
Nebraska,Douglas,2016,287660,278127,9533
Nevada,Douglas,2016,22243,20995,1248
Oregon,Douglas,2016,45693,42826,2867
South Dakota,Douglas,2016,1671,1629,42
Washington,Douglas,2016,20504,19087,1417
Wisconsin,Douglas,2016,23606,22369,1237
Arkansas,Drew,2016,7977,7525,452
Indiana,Dubois,2016,23392,22664,728
Iowa,Dubuque,2016,54537,52594,1943
Utah,Duchesne,2016,8113,7391,722
Massachusetts,Dukes,2016,9349,8866,483
Nebraska,Dundy,2016,1194,1168,26
Missouri,Dunklin,2016,12857,11798,1059
North Dakota,Dunn,2016,3247,3145,102
Wisconsin,Dunn,2016,24363,23368,995
Illinois,DuPage,2016,516207,491840,24367
North Carolina,Duplin,2016,26506,25094,1412
North Carolina,Durham,2016,162115,154825,7290
New York,Dutchess,2016,143032,137076,5956
Florida,Duval,2016,466779,443960,22819
Texas,Duval,2016,4882,4349,533
Tennessee,Dyer,2016,16307,15298,1009
Colorado,Eagle,2016,33696,32770,926
Georgia,Early,2016,4393,4091,302
Louisiana,East Baton Rouge Parish,2016,232108,220144,11964
Louisiana,East Carroll Parish,2016,2139,1891,248
Louisiana,East Feliciana Parish,2016,8102,7635,467
Texas,Eastland,2016,7417,7014,403
Michigan,Eaton,2016,56875,54530,2345
Wisconsin,Eau Claire,2016,58968,56957,2011
Georgia,Echols,2016,1879,1798,81
Texas,Ector,2016,76176,71340,4836
North Dakota,Eddy,2016,1278,1223,55
New Mexico,Eddy,2016,28685,26843,1842
Illinois,Edgar,2016,9706,9124,582
North Carolina,Edgecombe,2016,22421,20478,1943
South Carolina,Edgefield,2016,10565,9964,601
Kentucky,Edmonson,2016,4805,4505,300
South Dakota,Edmunds,2016,2163,2113,50
Illinois,Edwards,2016,2972,2799,173
Kansas,Edwards,2016,1652,1602,50
Texas,Edwards,2016,866,826,40
Georgia,Effingham,2016,28371,27002,1369
Illinois,Effingham,2016,18687,17804,883
California,El Dorado,2016,88810,84248,4562
Colorado,El Paso,2016,314454,302644,11810
Texas,El Paso,2016,349633,332375,17258
Colorado,Elbert,2016,13786,13428,358
Georgia,Elbert,2016,7717,7217,500
Kansas,Elk,2016,1187,1128,59
Pennsylvania,Elk,2016,16326,15428,898
Indiana,Elkhart,2016,108457,104678,3779
Nevada,Elko,2016,26924,25724,1200
Kentucky,Elliott,2016,2099,1856,243
Kansas,Ellis,2016,16994,16469,525
Oklahoma,Ellis,2016,2257,2171,86
Texas,Ellis,2016,84956,81779,3177
Kansas,Ellsworth,2016,2831,2722,109
Alabama,Elmore,2016,37384,35613,1771
Idaho,Elmore,2016,10973,10520,453
Georgia,Emanuel,2016,8432,7780,652
Utah,Emery,2016,4265,3998,267
Iowa,Emmet,2016,5581,5343,238
Michigan,Emmet,2016,17592,16446,1146
North Dakota,Emmons,2016,1584,1515,69
Virginia,Emporia city,2016,2242,2096,146
Texas,Erath,2016,20224,19405,819
New York,Erie,2016,445070,423157,21913
Ohio,Erie,2016,37409,35341,2068
Pennsylvania,Erie,2016,133534,124864,8670
Alabama,Escambia,2016,14613,13646,967
Florida,Escambia,2016,140696,133760,6936
Nevada,Esmeralda,2016,515,491,24
Massachusetts,Essex,2016,410540,394209,16331
New Jersey,Essex,2016,368262,346140,22122
New York,Essex,2016,17235,16315,920
Virginia,Essex,2016,5517,5247,270
Vermont,Essex,2016,2700,2566,134
Kentucky,Estill,2016,5241,4930,311
Alabama,Etowah,2016,43451,40892,2559
Nevada,Eureka,2016,988,943,45
Louisiana,Evangeline Parish,2016,12670,11731,939
Georgia,Evans,2016,4781,4546,235
Alaska,Fairbanks North Star Borough,2016,46394,43667,2727
Virginia,Fairfax,2016,615904,595834,20070
Virginia,Fairfax city,2016,12954,12554,400
Connecticut,Fairfield,2016,480577,457145,23432
Ohio,Fairfield,2016,75927,72627,3300
South Carolina,Fairfield,2016,10014,9289,725
Puerto Rico,Fajardo Municipio,2016,11285,9728,1557
South Dakota,Fall River,2016,3023,2891,132
Montana,Fallon,2016,1814,1748,66
Texas,Falls,2016,6607,6317,290
Virginia,Falls Church city,2016,7968,7748,220
Georgia,Fannin,2016,10811,10233,578
Texas,Fannin,2016,15760,15168,592
Minnesota,Faribault,2016,7346,7024,322
South Dakota,Faulk,2016,1113,1084,29
Arkansas,Faulkner,2016,60456,58164,2292
Virginia,Fauquier,2016,35876,34614,1262
Alabama,Fayette,2016,6623,6178,445
Georgia,Fayette,2016,55624,53005,2619
Iowa,Fayette,2016,10683,10208,475
Illinois,Fayette,2016,9753,9110,643
Indiana,Fayette,2016,9350,8812,538
Kentucky,Fayette,2016,171402,165244,6158
Ohio,Fayette,2016,14482,13836,646
Pennsylvania,Fayette,2016,58413,53690,4723
Tennessee,Fayette,2016,18216,17301,915
Texas,Fayette,2016,12485,12030,455
West Virginia,Fayette,2016,15967,14699,1268
Tennessee,Fentress,2016,7081,6645,436
Montana,Fergus,2016,5772,5545,227
Washington,Ferry,2016,2489,2231,258
Minnesota,Fillmore,2016,11537,11073,464
Nebraska,Fillmore,2016,3180,3092,88
Kansas,Finney,2016,20129,19507,622
Texas,Fisher,2016,1758,1683,75
Florida,Flagler,2016,45257,42779,2478
Montana,Flathead,2016,46004,43436,2568
Kentucky,Fleming,2016,5945,5572,373
South Carolina,Florence,2016,65488,62024,3464
Wisconsin,Florence,2016,2232,2100,132
Puerto Rico,Florida Municipio,2016,3370,2882,488
Georgia,Floyd,2016,43428,40822,2606
Iowa,Floyd,2016,8666,8351,315
Indiana,Floyd,2016,40981,39303,1678
Kentucky,Floyd,2016,11459,10156,1303
Texas,Floyd,2016,2736,2598,138
Virginia,Floyd,2016,8179,7843,336
Virginia,Fluvanna,2016,13164,12716,448
Texas,Foard,2016,540,520,20
#N/A,Fond du,WI,2016,57020,55016
Illinois,Ford,2016,6653,6292,361
Kansas,Ford,2016,17865,17300,565
Pennsylvania,Forest,2016,1890,1742,148
Wisconsin,Forest,2016,4006,3757,249
Mississippi,Forrest,2016,33404,31501,1903
Georgia,Forsyth,2016,110823,106203,4620
North Carolina,Forsyth,2016,182652,173776,8876
Texas,Fort Bend,2016,366735,348446,18289
North Dakota,Foster,2016,1685,1635,50
Indiana,Fountain,2016,7970,7507,463
Alabama,Franklin,2016,13924,13108,816
Arkansas,Franklin,2016,7353,7057,296
Florida,Franklin,2016,4728,4524,204
Georgia,Franklin,2016,9772,9261,511
Iowa,Franklin,2016,5929,5723,206
Idaho,Franklin,2016,6652,6448,204
Illinois,Franklin,2016,16692,15340,1352
Indiana,Franklin,2016,11477,10979,498
Kansas,Franklin,2016,14210,13614,596
Kentucky,Franklin,2016,24438,23436,1002
Massachusetts,Franklin,2016,39535,38150,1385
Maine,Franklin,2016,14423,13779,644
Missouri,Franklin,2016,52756,50453,2303
Mississippi,Franklin,2016,2855,2651,204
North Carolina,Franklin,2016,29347,27816,1531
Nebraska,Franklin,2016,1499,1454,45
New York,Franklin,2016,19788,18666,1122
Ohio,Franklin,2016,666583,638923,27660
Pennsylvania,Franklin,2016,77466,73480,3986
Tennessee,Franklin,2016,19768,18811,957
Texas,Franklin,2016,4507,4287,220
Virginia,Franklin,2016,26333,25192,1141
Vermont,Franklin,2016,27357,26510,847
Washington,Franklin,2016,39787,36820,2967
Virginia,Franklin city,2016,3533,3317,216
Louisiana,Franklin Parish,2016,7279,6619,660
Maryland,Frederick,2016,128923,123872,5051
Virginia,Frederick,2016,45277,43677,1600
Virginia,Fredericksburg city,2016,13542,12887,655
Minnesota,Freeborn,2016,16340,15717,623
Texas,Freestone,2016,6866,6408,458
Colorado,Fremont,2016,14697,13936,761
Iowa,Fremont,2016,3977,3846,131
Idaho,Fremont,2016,7382,7134,248
Wyoming,Fremont,2016,20026,18581,1445
California,Fresno,2016,444599,402365,42234
Texas,Frio,2016,8776,8350,426
Nebraska,Frontier,2016,1568,1524,44
Arkansas,Fulton,2016,4660,4458,202
Georgia,Fulton,2016,530235,501729,28506
Illinois,Fulton,2016,15803,14635,1168
Indiana,Fulton,2016,9887,9423,464
Kentucky,Fulton,2016,2067,1923,144
New York,Fulton,2016,23219,21891,1328
Ohio,Fulton,2016,22668,21607,1061
Pennsylvania,Fulton,2016,7301,6841,460
Nebraska,Furnas,2016,2711,2636,75
Florida,Gadsden,2016,18172,17039,1133
Nebraska,Gage,2016,11036,10675,361
Texas,Gaines,2016,9179,8838,341
Virginia,Galax city,2016,2899,2754,145
Illinois,Gallatin,2016,2534,2342,192
Kentucky,Gallatin,2016,3903,3713,190
Montana,Gallatin,2016,62187,60437,1750
Ohio,Gallia,2016,12122,11291,831
Texas,Galveston,2016,160038,151521,8517
Nebraska,Garden,2016,1186,1147,39
Colorado,Garfield,2016,30971,29888,1083
Montana,Garfield,2016,765,743,22
Nebraska,Garfield,2016,1154,1125,29
Oklahoma,Garfield,2016,29021,27756,1265
Utah,Garfield,2016,2794,2561,233
Washington,Garfield,2016,918,864,54
Arkansas,Garland,2016,40021,38301,1720
Kentucky,Garrard,2016,7524,7156,368
Maryland,Garrett,2016,15542,14657,885
Oklahoma,Garvin,2016,12725,12046,679
Texas,Garza,2016,2129,2046,83
Missouri,Gasconade,2016,7712,7380,332
North Carolina,Gaston,2016,105652,100025,5627
North Carolina,Gates,2016,5191,4925,266
Kansas,Geary,2016,12044,11365,679
Ohio,Geauga,2016,49486,47319,2167
Idaho,Gem,2016,7743,7379,364
Michigan,Genesee,2016,182491,172185,10306
New York,Genesee,2016,29726,28363,1363
Alabama,Geneva,2016,10853,10226,627
Missouri,Gentry,2016,3594,3460,134
Mississippi,George,2016,8818,8168,650
South Carolina,Georgetown,2016,25009,23303,1706
Indiana,Gibson,2016,19197,18501,696
Tennessee,Gibson,2016,21160,19924,1236
Arizona,Gila,2016,20965,19455,1510
Florida,Gilchrist,2016,6665,6333,332
Tennessee,Giles,2016,15219,14608,611
Virginia,Giles,2016,7932,7502,430
Texas,Gillespie,2016,12991,12622,369
Oregon,Gilliam,2016,837,788,49
Georgia,Gilmer,2016,11815,11145,670
West Virginia,Gilmer,2016,2539,2329,210
Colorado,Gilpin,2016,3481,3398,83
Montana,Glacier,2016,5824,5327,497
Florida,Glades,2016,4708,4416,292
Michigan,Gladwin,2016,9883,9193,690
Georgia,Glascock,2016,1266,1190,76
Texas,Glasscock,2016,749,720,29
California,Glenn,2016,12945,11867,1078
New Jersey,Gloucester,2016,148764,141227,7537
Virginia,Gloucester,2016,19064,18360,704
Georgia,Glynn,2016,39114,37040,2074
Michigan,Gogebic,2016,6333,5945,388
#N/A,Golden,MT,2016,379,362
#N/A,Golden,ND,2016,971,945
Texas,Goliad,2016,3316,3124,192
Texas,Gonzales,2016,9567,9162,405
Virginia,Goochland,2016,10815,10403,412
Minnesota,Goodhue,2016,26938,25938,1000
Idaho,Gooding,2016,8012,7766,246
Georgia,Gordon,2016,25259,23846,1413
Wyoming,Goshen,2016,7024,6780,244
Nebraska,Gosper,2016,1055,1028,27
Kansas,Gove,2016,1449,1414,35
Georgia,Grady,2016,10236,9680,556
Oklahoma,Grady,2016,26113,24818,1295
New Hampshire,Grafton,2016,48748,47596,1152
Arizona,Graham,2016,14352,13389,963
Kansas,Graham,2016,1223,1169,54
North Carolina,Graham,2016,3102,2828,274
Tennessee,Grainger,2016,9252,8752,500
Colorado,Grand,2016,9181,8934,247
Utah,Grand,2016,5727,5390,337
North Dakota,Grand Forks,2016,38797,37883,914
Vermont,Grand Isle,2016,3975,3827,148
Michigan,Grand Traverse,2016,49365,47247,2118
Montana,Granite,2016,1633,1537,96
Arkansas,Grant,2016,8261,7964,297
Indiana,Grant,2016,32141,30556,1585
Kansas,Grant,2016,3769,3635,134
Kentucky,Grant,2016,11347,10792,555
Minnesota,Grant,2016,3298,3144,154
North Dakota,Grant,2016,1296,1257,39
Nebraska,Grant,2016,452,442,10
New Mexico,Grant,2016,12460,11666,794
Oklahoma,Grant,2016,3007,2911,96
Oregon,Grant,2016,3108,2870,238
South Dakota,Grant,2016,4457,4314,143
Washington,Grant,2016,44501,41314,3187
Wisconsin,Grant,2016,28247,27144,1103
West Virginia,Grant,2016,5953,5599,354
Louisiana,Grant Parish,2016,8325,7743,582
North Carolina,Granville,2016,29283,28019,1264
Michigan,Gratiot,2016,18162,17222,940
Kentucky,Graves,2016,15306,14348,958
Kansas,Gray,2016,3406,3329,77
Texas,Gray,2016,8481,7898,583
Washington,Grays Harbor,2016,27197,24927,2270
Kentucky,Grayson,2016,10728,10002,726
Texas,Grayson,2016,61180,58827,2353
Virginia,Grayson,2016,7014,6652,362
Kansas,Greeley,2016,911,892,19
Nebraska,Greeley,2016,1232,1194,38
Kentucky,Green,2016,5000,4773,227
#N/A,Green,WI,2016,9778,9301
Wisconsin,Green,2016,21240,20534,706
West Virginia,Greenbrier,2016,15680,14832,848
Alabama,Greene,2016,2884,2598,286
Arkansas,Greene,2016,19774,18927,847
Georgia,Greene,2016,6593,6195,398
Iowa,Greene,2016,5651,5474,177
Illinois,Greene,2016,6070,5716,354
Indiana,Greene,2016,13741,12843,898
Missouri,Greene,2016,148822,143173,5649
Mississippi,Greene,2016,4289,3978,311
North Carolina,Greene,2016,9524,9021,503
New York,Greene,2016,20559,19521,1038
Ohio,Greene,2016,81065,77519,3546
Pennsylvania,Greene,2016,17290,15954,1336
Tennessee,Greene,2016,30763,29089,1674
Virginia,Greene,2016,9918,9590,328
Arizona,Greenlee,2016,3894,3600,294
Virginia,Greensville,2016,4202,3987,215
Kentucky,Greenup,2016,13891,12681,1210
South Carolina,Greenville,2016,245926,235461,10465
Kansas,Greenwood,2016,3319,3157,162
South Carolina,Greenwood,2016,31401,29770,1631
Oklahoma,Greer,2016,2192,2030,162
Texas,Gregg,2016,58332,54789,3543
South Dakota,Gregory,2016,2075,2013,62
Mississippi,Grenada,2016,9615,9125,490
North Dakota,Griggs,2016,1159,1126,33
Texas,Grimes,2016,11048,10319,729
Iowa,Grundy,2016,6617,6388,229
Illinois,Grundy,2016,25722,23999,1723
Missouri,Grundy,2016,4910,4686,224
Tennessee,Grundy,2016,4772,4464,308
New Mexico,Guadalupe,2016,1691,1583,108
Texas,Guadalupe,2016,75931,73213,2718
Puerto Rico,Guanica Municipio,2016,4142,3394,748
Puerto Rico,Guayama Municipio,2016,12052,10076,1976
Puerto Rico,Guayanilla Municipio,2016,5292,4302,990
Puerto Rico,Guaynabo Municipio,2016,37190,34975,2215
Ohio,Guernsey,2016,18883,17538,1345
North Carolina,Guilford,2016,258484,244973,13511
Florida,Gulf,2016,5955,5679,276
Colorado,Gunnison,2016,10127,9894,233
Puerto Rico,Gurabo Municipio,2016,17513,16026,1487
Iowa,Guthrie,2016,5609,5407,202
Georgia,Gwinnett,2016,466965,444758,22207
South Dakota,Haakon,2016,1106,1079,27
Georgia,Habersham,2016,19271,18254,1017
Alaska,Haines Borough,2016,1073,963,110
Alabama,Hale,2016,6006,5548,458
Texas,Hale,2016,12585,11879,706
North Carolina,Halifax,2016,20684,19047,1637
Virginia,Halifax,2016,14848,13973,875
Georgia,Hall,2016,96156,91834,4322
Nebraska,Hall,2016,31371,30221,1150
Texas,Hall,2016,1165,1087,78
Tennessee,Hamblen,2016,26753,25390,1363
Florida,Hamilton,2016,4648,4386,262
Iowa,Hamilton,2016,7121,6853,268
Illinois,Hamilton,2016,4257,3990,267
Indiana,Hamilton,2016,174473,168883,5590
Kansas,Hamilton,2016,1641,1597,44
Nebraska,Hamilton,2016,4647,4518,129
New York,Hamilton,2016,2363,2210,153
Ohio,Hamilton,2016,404791,386761,18030
Tennessee,Hamilton,2016,171297,163427,7870
Texas,Hamilton,2016,3598,3422,176
South Dakota,Hamlin,2016,3173,3067,106
Massachusetts,Hampden,2016,221992,210339,11653
Massachusetts,Hampshire,2016,88038,84846,3192
West Virginia,Hampshire,2016,9892,9461,431
South Carolina,Hampton,2016,8243,7760,483
Virginia,Hampton city,2016,63889,60210,3679
Georgia,Hancock,2016,2527,2315,212
Iowa,Hancock,2016,6373,6201,172
Illinois,Hancock,2016,8829,8253,576
Indiana,Hancock,2016,38682,37218,1464
Kentucky,Hancock,2016,4039,3821,218
Maine,Hancock,2016,29129,27817,1312
Mississippi,Hancock,2016,18885,17740,1145
Ohio,Hancock,2016,41446,39908,1538
Tennessee,Hancock,2016,2026,1866,160
West Virginia,Hancock,2016,12854,11952,902
South Dakota,Hand,2016,1831,1792,39
Virginia,Hanover,2016,57094,55071,2023
Texas,Hansford,2016,2944,2852,92
South Dakota,Hanson,2016,1769,1709,60
Georgia,Haralson,2016,12138,11435,703
Florida,Hardee,2016,9237,8626,611
Tennessee,Hardeman,2016,9161,8599,562
Texas,Hardeman,2016,1624,1560,64
Iowa,Hardin,2016,8550,8217,333
Illinois,Hardin,2016,1399,1263,136
Kentucky,Hardin,2016,47783,45627,2156
Ohio,Hardin,2016,14372,13650,722
Tennessee,Hardin,2016,10168,9562,606
Texas,Hardin,2016,25148,23620,1528
New Mexico,Harding,2016,277,258,19
South Dakota,Harding,2016,761,739,22
West Virginia,Hardy,2016,5715,5389,326
Maryland,Harford,2016,136631,130843,5788
Kentucky,Harlan,2016,6747,5854,893
Nebraska,Harlan,2016,1755,1711,44
Oklahoma,Harmon,2016,1293,1244,49
North Carolina,Harnett,2016,51461,48486,2975
Oregon,Harney,2016,3423,3209,214
Kansas,Harper,2016,2878,2775,103
Oklahoma,Harper,2016,1911,1838,73
Georgia,Harris,2016,16042,15260,782
Texas,Harris,2016,2249341,2129674,119667
Iowa,Harrison,2016,7430,7179,251
Indiana,Harrison,2016,19955,19116,839
Kentucky,Harrison,2016,8492,8089,403
Missouri,Harrison,2016,3979,3811,168
Mississippi,Harrison,2016,86791,82022,4769
Ohio,Harrison,2016,6967,6432,535
Texas,Harrison,2016,29935,28140,1795
West Virginia,Harrison,2016,32336,30446,1890
Virginia,Harrisonburg city,2016,24199,23019,1180
Georgia,Hart,2016,10994,10404,590
Kentucky,Hart,2016,7901,7525,376
Connecticut,Hartford,2016,474272,448868,25404
Texas,Hartley,2016,2959,2899,60
Kansas,Harvey,2016,17186,16459,727
Kansas,Haskell,2016,2302,2242,60
Oklahoma,Haskell,2016,4507,4135,372
Texas,Haskell,2016,2508,2402,106
Puerto Rico,Hatillo Municipio,2016,13323,11253,2070
Hawaii,Hawaii,2016,93057,89703,3354
Tennessee,Hawkins,2016,23623,22352,1271
Nebraska,Hayes,2016,589,575,14
Texas,Hays,2016,104838,101347,3491
North Carolina,Haywood,2016,28486,27193,1293
Tennessee,Haywood,2016,7649,7154,495
Georgia,Heard,2016,4987,4693,294
Texas,Hemphill,2016,2114,2035,79
Arkansas,Hempstead,2016,9988,9613,375
Illinois,Henderson,2016,3717,3490,227
Kentucky,Henderson,2016,21600,20567,1033
North Carolina,Henderson,2016,52299,50072,2227
Tennessee,Henderson,2016,11944,11129,815
Texas,Henderson,2016,35369,33718,1651
Indiana,Hendricks,2016,85776,82780,2996
Florida,Hendry,2016,15374,14071,1303
Minnesota,Hennepin,2016,687887,664996,22891
Virginia,Henrico,2016,178604,171571,7033
Alabama,Henry,2016,6749,6311,438
Georgia,Henry,2016,108731,102754,5977
Iowa,Henry,2016,9536,9197,339
Illinois,Henry,2016,25215,23692,1523
Indiana,Henry,2016,22114,21093,1021
Kentucky,Henry,2016,7925,7597,328
Missouri,Henry,2016,9907,9412,495
Ohio,Henry,2016,13600,12869,731
Tennessee,Henry,2016,13873,13058,815
Virginia,Henry,2016,22114,20866,1248
New York,Herkimer,2016,28164,26626,1538
Florida,Hernando,2016,67794,63712,4082
North Carolina,Hertford,2016,9316,8704,612
North Dakota,Hettinger,2016,1539,1493,46
Kentucky,Hickman,2016,1921,1805,116
Tennessee,Hickman,2016,10398,9918,480
Missouri,Hickory,2016,3701,3493,208
New Mexico,Hidalgo,2016,2202,2082,120
Texas,Hidalgo,2016,336926,310647,26279
Ohio,Highland,2016,16924,15845,1079
Virginia,Highland,2016,1306,1264,42
Florida,Highlands,2016,35655,33334,2321
Montana,Hill,2016,7808,7471,337
Texas,Hill,2016,15799,15104,695
Florida,Hillsborough,2016,705974,674848,31126
New Hampshire,Hillsborough,2016,232001,224981,7020
Michigan,Hillsdale,2016,21169,20098,1071
Mississippi,Hinds,2016,110065,104105,5960
Colorado,Hinsdale,2016,447,436,11
Nebraska,Hitchcock,2016,1304,1257,47
Ohio,Hocking,2016,13005,12275,730
Texas,Hockley,2016,11167,10649,518
Kansas,Hodgeman,2016,1028,1001,27
North Carolina,Hoke,2016,19916,18605,1311
Florida,Holmes,2016,6699,6339,360
Mississippi,Holmes,2016,5981,5326,655
Ohio,Holmes,2016,20983,20222,761
Missouri,Holt,2016,2689,2602,87
Nebraska,Holt,2016,5852,5708,144
Hawaii,Honolulu/city,2016,466140,453131,13009
Texas,Hood,2016,25255,24070,1185
Oregon,Hood River,2016,13906,13330,576
Nebraska,Hooker,2016,391,377,14
Alaska,Hoonah-Angoon Census Area,2016,1202,1060,142
Virginia,Hopewell city,2016,9766,9122,644
Kentucky,Hopkins,2016,19635,18506,1129
Texas,Hopkins,2016,17317,16628,689
Puerto Rico,Hormigueros Municipio,2016,5621,4933,688
South Carolina,Horry,2016,140424,132187,8237
Arkansas,Hot Spring,2016,14092,13539,553
Wyoming,Hot Springs,2016,2424,2307,117
Michigan,Houghton,2016,16559,15545,1014
Alabama,Houston,2016,44735,42156,2579
Georgia,Houston,2016,67559,63950,3609
Minnesota,Houston,2016,10636,10221,415
Tennessee,Houston,2016,3186,2947,239
Texas,Houston,2016,10058,9595,463
Arkansas,Howard,2016,5970,5775,195
Iowa,Howard,2016,5315,5124,191
Indiana,Howard,2016,38078,36304,1774
Maryland,Howard,2016,179621,173675,5946
Missouri,Howard,2016,5038,4815,223
Nebraska,Howard,2016,3296,3187,109
Texas,Howard,2016,13207,12477,730
Missouri,Howell,2016,16143,15118,1025
Minnesota,Hubbard,2016,9827,9191,636
New Jersey,Hudson,2016,359225,342429,16796
Texas,Hudspeth,2016,1541,1449,92
Colorado,Huerfano,2016,2499,2341,158
Oklahoma,Hughes,2016,5519,5119,400
South Dakota,Hughes,2016,10063,9825,238
Puerto Rico,Humacao Municipio,2016,17467,15004,2463
California,Humboldt,2016,62413,59337,3076
Iowa,Humboldt,2016,5372,5217,155
Nevada,Humboldt,2016,8052,7612,440
Mississippi,Humphreys,2016,2375,2105,270
Tennessee,Humphreys,2016,8611,8095,516
Texas,Hunt,2016,40499,38767,1732
New Jersey,Hunterdon,2016,64277,61855,2422
Pennsylvania,Huntingdon,2016,19656,18286,1370
Indiana,Huntington,2016,18687,17928,759
Michigan,Huron,2016,15992,15165,827
Ohio,Huron,2016,28107,26267,1840
South Dakota,Hutchinson,2016,3650,3557,93
Texas,Hutchinson,2016,9630,9089,541
North Carolina,Hyde,2016,2110,1910,200
South Dakota,Hyde,2016,698,679,19
Louisiana,Iberia Parish,2016,30110,27282,2828
Louisiana,Iberville Parish,2016,14108,13141,967
Iowa,Ida,2016,4014,3911,103
Idaho,Idaho,2016,6352,5992,360
California,Imperial,2016,75141,56997,18144
Arkansas,Independence,2016,15986,15195,791
Florida,Indian River,2016,62067,58348,3719
Pennsylvania,Indiana,2016,40150,37234,2916
Michigan,Ingham,2016,148872,142487,6385
California,Inyo,2016,8857,8389,468
Michigan,Ionia,2016,29646,28395,1251
Michigan,Iosco,2016,10106,9370,736
Iowa,Iowa,2016,10530,10202,328
Wisconsin,Iowa,2016,13720,13239,481
North Carolina,Iredell,2016,84565,80506,4059
Texas,Irion,2016,780,755,25
Michigan,Iron,2016,5216,4878,338
Missouri,Iron,2016,3721,3454,267
Utah,Iron,2016,21467,20531,936
Wisconsin,Iron,2016,2642,2446,196
Illinois,Iroquois,2016,14795,13980,815
Georgia,Irwin,2016,3213,2962,251
Puerto Rico,Isabela Municipio,2016,12613,10835,1778
Michigan,Isabella,2016,35341,33681,1660
Minnesota,Isanti,2016,20744,19778,966
Washington,Island,2016,32678,30747,1931
Virginia,Isle of Wight,2016,18905,18082,823
Mississippi,Issaquena,2016,401,345,56
Minnesota,Itasca,2016,22098,20214,1884
Mississippi,Itawamba,2016,10409,9884,525
Arkansas,Izard,2016,4959,4681,278
Texas,Jack,2016,3853,3663,190
Alabama,Jackson,2016,23681,22193,1488
Arkansas,Jackson,2016,6048,5671,377
Colorado,Jackson,2016,891,867,24
Florida,Jackson,2016,17307,16408,899
Georgia,Jackson,2016,33234,31819,1415
Iowa,Jackson,2016,11034,10571,463
Illinois,Jackson,2016,28679,27133,1546
Indiana,Jackson,2016,22344,21527,817
Kansas,Jackson,2016,7251,7000,251
Kentucky,Jackson,2016,4168,3836,332
Michigan,Jackson,2016,74383,70781,3602
Minnesota,Jackson,2016,6119,5843,276
Missouri,Jackson,2016,364782,346091,18691
Mississippi,Jackson,2016,59142,55271,3871
North Carolina,Jackson,2016,18831,17809,1022
Ohio,Jackson,2016,12797,11786,1011
Oklahoma,Jackson,2016,11012,10529,483
Oregon,Jackson,2016,101378,95552,5826
South Dakota,Jackson,2016,1304,1250,54
Tennessee,Jackson,2016,4476,4164,312
Texas,Jackson,2016,7271,6932,339
Wisconsin,Jackson,2016,10344,9891,453
West Virginia,Jackson,2016,12001,11222,779
Louisiana,Jackson Parish,2016,7083,6688,395
Virginia,James City,2016,34816,33453,1363
Georgia,Jasper,2016,6571,6257,314
Iowa,Jasper,2016,19194,18512,682
Illinois,Jasper,2016,4647,4355,292
Indiana,Jasper,2016,16570,15688,882
Missouri,Jasper,2016,57829,55422,2407
Mississippi,Jasper,2016,6196,5723,473
South Carolina,Jasper,2016,12018,11492,526
Texas,Jasper,2016,13460,12429,1031
Indiana,Jay,2016,9945,9494,451
Puerto Rico,Jayuya Municipio,2016,4221,3675,546
Georgia,Jeff Davis,2016,6217,5822,395
Texas,Jeff Davis,2016,1072,1041,31
Alabama,Jefferson,2016,312478,294630,17848
Arkansas,Jefferson,2016,28278,26695,1583
Colorado,Jefferson,2016,315094,305778,9316
Florida,Jefferson,2016,5376,5095,281
Georgia,Jefferson,2016,6586,6100,486
Iowa,Jefferson,2016,9160,8824,336
Idaho,Jefferson,2016,12848,12451,397
Illinois,Jefferson,2016,17568,16442,1126
Indiana,Jefferson,2016,15285,14573,712
Kansas,Jefferson,2016,10205,9808,397
Kentucky,Jefferson,2016,386617,369452,17165
Missouri,Jefferson,2016,117823,112753,5070
Mississippi,Jefferson,2016,2228,1897,331
Montana,Jefferson,2016,5676,5415,261
Nebraska,Jefferson,2016,4216,4115,101
New York,Jefferson,2016,45649,42804,2845
Ohio,Jefferson,2016,28897,26469,2428
Oklahoma,Jefferson,2016,2712,2519,193
Oregon,Jefferson,2016,9859,9207,652
Pennsylvania,Jefferson,2016,20694,19281,1413
Tennessee,Jefferson,2016,23529,22290,1239
Texas,Jefferson,2016,107450,99932,7518
Washington,Jefferson,2016,11488,10675,813
Wisconsin,Jefferson,2016,45775,43996,1779
West Virginia,Jefferson,2016,28546,27584,962
Mississippi,Jefferson Davis,2016,4183,3840,343
Louisiana,Jefferson Davis Parish,2016,13574,12757,817
Louisiana,Jefferson Parish,2016,216473,205046,11427
Georgia,Jenkins,2016,3157,2919,238
Indiana,Jennings,2016,13265,12635,630
South Dakota,Jerauld,2016,1071,1045,26
Idaho,Jerome,2016,11366,11008,358
Illinois,Jersey,2016,11055,10410,645
Kentucky,Jessamine,2016,25654,24644,1010
Kansas,Jewell,2016,1329,1272,57
Texas,Jim Hogg,2016,1943,1758,185
Texas,Jim Wells,2016,17452,15614,1838
Illinois,Jo Daviess,2016,11376,10764,612
Arkansas,Johnson,2016,10516,10018,498
Georgia,Johnson,2016,3920,3681,239
Iowa,Johnson,2016,84086,81903,2183
Illinois,Johnson,2016,4209,3842,367
Indiana,Johnson,2016,80246,77330,2916
Kansas,Johnson,2016,327981,317290,10691
Kentucky,Johnson,2016,7015,6288,727
Missouri,Johnson,2016,23221,22081,1140
Nebraska,Johnson,2016,2089,2023,66
Tennessee,Johnson,2016,7514,7154,360
Texas,Johnson,2016,76008,72703,3305
Wyoming,Johnson,2016,4205,3979,226
North Carolina,Johnston,2016,91592,87311,4281
Oklahoma,Johnston,2016,4377,4121,256
Georgia,Jones,2016,13771,13110,661
Iowa,Jones,2016,10660,10203,457
Mississippi,Jones,2016,25811,24239,1572
North Carolina,Jones,2016,4515,4277,238
South Dakota,Jones,2016,569,556,13
Texas,Jones,2016,5622,5297,325
Oregon,Josephine,2016,34281,32061,2220
Utah,Juab,2016,5218,5028,190
Puerto Rico,Juana Diaz Municipio,2016,15597,13338,2259
Montana,Judith Basin,2016,934,902,32
Puerto Rico,Juncos Municipio,2016,12462,10817,1645
Wisconsin,Juneau,2016,13559,12959,600
Alaska,Juneau Borough/city,2016,17316,16540,776
Pennsylvania,Juniata,2016,12196,11544,652
Michigan,Kalamazoo,2016,131966,126621,5345
Michigan,Kalkaska,2016,7717,7163,554
Minnesota,Kanabec,2016,9021,8436,585
West Virginia,Kanawha,2016,85268,80606,4662
Minnesota,Kandiyohi,2016,24271,23351,920
Illinois,Kane,2016,270169,255214,14955
Utah,Kane,2016,3693,3552,141
Illinois,Kankakee,2016,54706,51162,3544
Texas,Karnes,2016,6274,5968,306
Hawaii,Kauai,2016,36810,35657,1153
Texas,Kaufman,2016,57893,55704,2189
Oklahoma,Kay,2016,18961,17766,1195
Nebraska,Kearney,2016,3736,3648,88
Kansas,Kearny,2016,2056,1991,65
Nebraska,Keith,2016,4611,4478,133
Mississippi,Kemper,2016,3556,3247,309
Alaska,Kenai Peninsula Borough,2016,27127,24818,2309
Illinois,Kendall,2016,67876,64412,3464
Texas,Kendall,2016,20338,19689,649
Texas,Kenedy,2016,217,207,10
Maine,Kennebec,2016,62194,59932,2262
Wisconsin,Kenosha,2016,88448,84339,4109
Delaware,Kent,2016,77196,73404,3792
Maryland,Kent,2016,10265,9764,501
Michigan,Kent,2016,350238,337914,12324
Rhode Island,Kent,2016,90721,86433,4288
Texas,Kent,2016,469,455,14
Kentucky,Kenton,2016,84703,81200,3503
Iowa,Keokuk,2016,5307,5079,228
California,Kern,2016,387978,347694,40284
Texas,Kerr,2016,21349,20583,766
South Carolina,Kershaw,2016,29296,27761,1535
Alaska,Ketchikan Gateway Borough,2016,7015,6558,457
Wisconsin,Kewaunee,2016,11051,10646,405
Michigan,Keweenaw,2016,941,860,81
Nebraska,Keya Paha,2016,619,606,13
North Dakota,Kidder,2016,1375,1323,52
Nebraska,Kimball,2016,1969,1889,80
Texas,Kimble,2016,1951,1877,74
Texas,King,2016,178,171,7
Washington,King,2016,1213744,1167122,46622
Virginia,King and Queen,2016,3655,3501,154
Virginia,King George,2016,12304,11772,532
Virginia,King William,2016,8738,8403,335
Oklahoma,Kingfisher,2016,8457,8177,280
Kansas,Kingman,2016,3524,3369,155
California,Kings,2016,57141,51446,5695
New York,Kings,2016,1214539,1149735,64804
South Dakota,Kingsbury,2016,2740,2668,72
Texas,Kinney,2016,1156,1089,67
Colorado,Kiowa,2016,846,829,17
Kansas,Kiowa,2016,1418,1379,39
Oklahoma,Kiowa,2016,4113,3894,219
Colorado,Kit Carson,2016,4534,4438,96
Washington,Kitsap,2016,117955,111377,6578
Washington,Kittitas,2016,21495,20212,1283
Minnesota,Kittson,2016,2412,2302,110
Oregon,Klamath,2016,29222,27242,1980
Texas,Kleberg,2016,14103,13157,946
Washington,Klickitat,2016,9627,8970,657
Kentucky,Knott,2016,4561,4030,531
Illinois,Knox,2016,22941,21528,1413
Indiana,Knox,2016,19063,18230,833
Kentucky,Knox,2016,9899,9103,796
Maine,Knox,2016,20675,19948,727
Missouri,Knox,2016,1987,1915,72
Nebraska,Knox,2016,4714,4570,144
Ohio,Knox,2016,31219,29766,1453
Tennessee,Knox,2016,232864,223589,9275
Texas,Knox,2016,1558,1492,66
Alaska,Kodiak Island Borough,2016,6409,6079,330
Minnesota,Koochiching,2016,6183,5659,524
Idaho,Kootenai,2016,73965,70512,3453
Indiana,Kosciusko,2016,41495,39941,1554
Iowa,Kossuth,2016,8870,8638,232
Alaska,Kusilvak Census Area,2016,2721,2133,588
Wisconsin,La Crosse,2016,67666,65227,2439
Arizona,La Paz,2016,8459,7949,510
Colorado,La Plata,2016,30961,30072,889
Texas,La Salle,2016,3884,3685,199
Kansas,Labette,2016,10722,10143,579
Minnesota,Lac qui Parle,2016,3631,3476,155
Pennsylvania,Lackawanna,2016,106729,100704,6025
Missouri,Laclede,2016,16186,15303,883
Arkansas,Lafayette,2016,2578,2428,150
Florida,Lafayette,2016,2962,2833,129
Missouri,Lafayette,2016,17219,16476,743
Mississippi,Lafayette,2016,26008,24746,1262
Wisconsin,Lafayette,2016,9859,9546,313
Louisiana,Lafayette Parish,2016,114343,107328,7015
Louisiana,Lafourche Parish,2016,43290,40569,2721
Indiana,LaGrange,2016,19422,18752,670
Puerto Rico,Lajas Municipio,2016,5631,4580,1051
California,Lake,2016,29061,27108,1953
Colorado,Lake,2016,4613,4481,132
Florida,Lake,2016,145832,138781,7051
Illinois,Lake,2016,371791,352296,19495
Indiana,Lake,2016,232236,217542,14694
Michigan,Lake,2016,3751,3470,281
Minnesota,Lake,2016,5435,5090,345
Montana,Lake,2016,13094,12474,620
Ohio,Lake,2016,125662,119629,6033
Oregon,Lake,2016,3452,3232,220
South Dakota,Lake,2016,6456,6237,219
Tennessee,Lake,2016,1908,1760,148
Alaska,Lake and Peninsula Borough,2016,655,573,82
Minnesota,Lake of the Woods,2016,2391,2276,115
Alabama,Lamar,2016,5713,5392,321
Georgia,Lamar,2016,7886,7369,517
Mississippi,Lamar,2016,29627,28288,1339
Texas,Lamar,2016,23219,22146,1073
Texas,Lamb,2016,5245,4905,340
Vermont,Lamoille,2016,13922,13333,589
North Dakota,LaMoure,2016,2314,2259,55
Texas,Lampasas,2016,9157,8777,380
Nebraska,Lancaster,2016,168830,164151,4679
Pennsylvania,Lancaster,2016,279731,268202,11529
South Carolina,Lancaster,2016,38406,36354,2052
Virginia,Lancaster,2016,5103,4813,290
Nevada,Lander,2016,3130,2935,195
Kansas,Lane,2016,810,785,25
Oregon,Lane,2016,178428,169361,9067
Wisconsin,Langlade,2016,9591,9094,497
Georgia,Lanier,2016,3822,3601,221
Michigan,Lapeer,2016,40758,38137,2621
Indiana,LaPorte,2016,48647,45786,2861
Wyoming,Laramie,2016,48772,46740,2032
Puerto Rico,Lares Municipio,2016,7412,5980,1432
Colorado,Larimer,2016,187205,181951,5254
Kentucky,Larue,2016,5898,5624,274
Colorado,Las Animas,2016,6182,5870,312
Puerto Rico,Las Marias Municipio,2016,2865,2439,426
Puerto Rico,Las Piedras Municipio,2016,11365,9835,1530
Illinois,LaSalle,2016,57117,53251,3866
Louisiana,LaSalle Parish,2016,6270,5855,415
California,Lassen,2016,10360,9642,718
Idaho,Latah,2016,19930,19298,632
Oklahoma,Latimer,2016,3728,3407,321
Alabama,Lauderdale,2016,42703,39998,2705
Mississippi,Lauderdale,2016,31802,29942,1860
Tennessee,Lauderdale,2016,9400,8676,724
Kentucky,Laurel,2016,23913,22421,1492
Georgia,Laurens,2016,19032,17767,1265
South Carolina,Laurens,2016,30085,28512,1573
Texas,Lavaca,2016,8738,8370,368
Alabama,Lawrence,2016,13775,12828,947
Arkansas,Lawrence,2016,6906,6607,299
Illinois,Lawrence,2016,6176,5717,459
Indiana,Lawrence,2016,20593,19423,1170
Kentucky,Lawrence,2016,5045,4491,554
Missouri,Lawrence,2016,17815,17036,779
Mississippi,Lawrence,2016,4679,4347,332
Ohio,Lawrence,2016,24743,23123,1620
Pennsylvania,Lawrence,2016,41491,38709,2782
South Dakota,Lawrence,2016,13062,12632,430
Tennessee,Lawrence,2016,17731,16711,1020
Oklahoma,Le Flore,2016,19773,18411,1362
Minnesota,Le Sueur,2016,15611,14850,761
New Mexico,Lea,2016,27727,25200,2527
Mississippi,Leake,2016,7759,7291,468
Kansas,Leavenworth,2016,35747,34206,1541
Pennsylvania,Lebanon,2016,70557,67401,3156
Alabama,Lee,2016,72653,68867,3786
Arkansas,Lee,2016,3087,2942,145
Florida,Lee,2016,328730,313612,15118
Georgia,Lee,2016,14533,13852,681
Iowa,Lee,2016,17416,16364,1052
Illinois,Lee,2016,18021,17095,926
Kentucky,Lee,2016,1899,1712,187
Mississippi,Lee,2016,40839,38861,1978
North Carolina,Lee,2016,26231,24691,1540
South Carolina,Lee,2016,6450,5992,458
Texas,Lee,2016,9280,8930,350
Virginia,Lee,2016,8435,7856,579
Michigan,Leelanau,2016,10571,10057,514
Mississippi,Leflore,2016,10340,9406,934
Pennsylvania,Lehigh,2016,188955,178878,10077
Idaho,Lemhi,2016,3414,3205,209
Michigan,Lenawee,2016,47334,45161,2173
North Carolina,Lenoir,2016,27651,26032,1619
Florida,Leon,2016,149944,143181,6763
Texas,Leon,2016,6508,6087,421
Kentucky,Leslie,2016,2792,2413,379
Kentucky,Letcher,2016,6429,5627,802
Florida,Levy,2016,16617,15762,855
Idaho,Lewis,2016,1629,1525,104
Kentucky,Lewis,2016,4745,4275,470
Missouri,Lewis,2016,5146,4913,233
New York,Lewis,2016,11739,10951,788
Tennessee,Lewis,2016,4869,4581,288
Washington,Lewis,2016,31866,29375,2491
West Virginia,Lewis,2016,6826,6245,581
Montana,Lewis and Clark,2016,35230,34067,1163
South Carolina,Lexington,2016,148313,142252,6061
Virginia,Lexington city,2016,2262,2122,140
Florida,Liberty,2016,2632,2498,134
Georgia,Liberty,2016,25004,23542,1462
Montana,Liberty,2016,990,959,31
Texas,Liberty,2016,31525,29156,2369
Ohio,Licking,2016,88215,84323,3892
Alabama,Limestone,2016,40853,38720,2133
Texas,Limestone,2016,8322,7857,465
Arkansas,Lincoln,2016,4088,3891,197
Colorado,Lincoln,2016,2277,2219,58
Georgia,Lincoln,2016,3472,3268,204
Idaho,Lincoln,2016,2646,2528,118
Kansas,Lincoln,2016,1735,1676,59
Kentucky,Lincoln,2016,9149,8588,561
Maine,Lincoln,2016,16986,16358,628
Minnesota,Lincoln,2016,3395,3271,124
Missouri,Lincoln,2016,27271,26047,1224
Mississippi,Lincoln,2016,14433,13616,817
Montana,Lincoln,2016,7938,7223,715
North Carolina,Lincoln,2016,41095,39160,1935
Nebraska,Lincoln,2016,18687,18113,574
New Mexico,Lincoln,2016,8641,8133,508
Nevada,Lincoln,2016,1985,1880,105
Oklahoma,Lincoln,2016,15893,15049,844
Oregon,Lincoln,2016,20893,19721,1172
South Dakota,Lincoln,2016,31437,30760,677
Tennessee,Lincoln,2016,15908,15258,650
Washington,Lincoln,2016,4882,4609,273
Wisconsin,Lincoln,2016,15285,14618,667
West Virginia,Lincoln,2016,7287,6664,623
Wyoming,Lincoln,2016,8719,8308,411
Louisiana,Lincoln Parish,2016,21462,20129,1333
Iowa,Linn,2016,118477,114131,4346
Kansas,Linn,2016,4338,4059,279
Missouri,Linn,2016,5282,4927,355
Oregon,Linn,2016,56815,53574,3241
Texas,Lipscomb,2016,1651,1578,73
Connecticut,Litchfield,2016,104743,99796,4947
Arkansas,Little River,2016,5584,5323,261
Texas,Live Oak,2016,5201,4893,308
Illinois,Livingston,2016,17027,16105,922
Kentucky,Livingston,2016,3687,3420,267
Michigan,Livingston,2016,100123,96031,4092
Missouri,Livingston,2016,7362,7074,288
New York,Livingston,2016,31030,29498,1532
Louisiana,Livingston Parish,2016,68671,65194,3477
Texas,Llano,2016,8289,7944,345
Arkansas,Logan,2016,9114,8696,418
Colorado,Logan,2016,11006,10682,324
Illinois,Logan,2016,13042,12346,696
Kansas,Logan,2016,1721,1677,44
Kentucky,Logan,2016,11731,11211,520
North Dakota,Logan,2016,960,926,34
Nebraska,Logan,2016,483,469,14
Ohio,Logan,2016,23313,22330,983
Oklahoma,Logan,2016,21595,20723,872
West Virginia,Logan,2016,11154,10015,1139
Puerto Rico,Loiza Municipio,2016,8654,7675,979
Georgia,Long,2016,7412,7012,400
Arkansas,Lonoke,2016,33335,32226,1109
Ohio,Lorain,2016,153570,144544,9026
New Mexico,Los Alamos,2016,8797,8429,368
California,Los Angeles,2016,5030508,4765899,264609
Tennessee,Loudon,2016,22202,21168,1034
Virginia,Loudoun,2016,207000,200319,6681
Iowa,Louisa,2016,6087,5848,239
Virginia,Louisa,2016,18543,17827,716
Nebraska,Loup,2016,396,382,14
Oklahoma,Love,2016,6577,6370,207
Texas,Loving,2016,86,82,4
Alabama,Lowndes,2016,3815,3414,401
Georgia,Lowndes,2016,51227,48527,2700
Mississippi,Lowndes,2016,25535,23975,1560
Texas,Lubbock,2016,153504,148310,5194
Iowa,Lucas,2016,4370,4231,139
Ohio,Lucas,2016,210347,199375,10972
Michigan,Luce,2016,2401,2239,162
Georgia,Lumpkin,2016,15945,15183,762
New Mexico,Luna,2016,10771,9225,1546
Virginia,Lunenburg,2016,5245,5001,244
Puerto Rico,Luquillo Municipio,2016,6333,5434,899
Pennsylvania,Luzerne,2016,158671,148700,9971
Pennsylvania,Lycoming,2016,58697,54813,3884
South Dakota,Lyman,2016,1775,1692,83
Virginia,Lynchburg city,2016,35473,33610,1863
Texas,Lynn,2016,2729,2621,108
Iowa,Lyon,2016,7068,6924,144
Kansas,Lyon,2016,16802,16114,688
Kentucky,Lyon,2016,2960,2785,175
Minnesota,Lyon,2016,15238,14697,541
Nevada,Lyon,2016,21267,19674,1593
Michigan,Mackinac,2016,5188,4675,513
Michigan,Macomb,2016,436316,413581,22735
Alabama,Macon,2016,7900,7301,599
Georgia,Macon,2016,4671,4285,386
Illinois,Macon,2016,50568,47229,3339
Missouri,Macon,2016,7626,7262,364
North Carolina,Macon,2016,15219,14400,819
Tennessee,Macon,2016,10201,9757,444
Illinois,Macoupin,2016,23358,21966,1392
California,Madera,2016,61032,55393,5639
Alabama,Madison,2016,174275,165388,8887
Arkansas,Madison,2016,7274,7041,233
Florida,Madison,2016,7312,6929,383
Georgia,Madison,2016,13062,12417,645
Iowa,Madison,2016,8229,7937,292
Idaho,Madison,2016,20599,20101,498
Illinois,Madison,2016,135113,127149,7964
Indiana,Madison,2016,58964,55991,2973
Kentucky,Madison,2016,45097,43198,1899
Missouri,Madison,2016,5487,5185,302
Mississippi,Madison,2016,53406,51114,2292
Montana,Madison,2016,4418,4251,167
North Carolina,Madison,2016,9702,9230,472
Nebraska,Madison,2016,19136,18610,526
New York,Madison,2016,32694,30973,1721
Ohio,Madison,2016,20329,19524,805
Tennessee,Madison,2016,47628,45317,2311
Texas,Madison,2016,4766,4524,242
Virginia,Madison,2016,7162,6936,226
Louisiana,Madison Parish,2016,3835,3491,344
Kentucky,Magoffin,2016,3148,2522,626
Iowa,Mahaska,2016,11768,11330,438
Minnesota,Mahnomen,2016,2397,2259,138
Ohio,Mahoning,2016,105917,99115,6802
Oklahoma,Major,2016,3997,3833,164
Oregon,Malheur,2016,12475,11787,688
Virginia,Manassas city,2016,21566,20779,787
Virginia,Manassas Park city,2016,8469,8157,312
Florida,Manatee,2016,170287,162567,7720
Puerto Rico,Manati Municipio,2016,11648,10295,1353
Michigan,Manistee,2016,10530,9840,690
Wisconsin,Manitowoc,2016,41912,40109,1803
Wisconsin,Marathon,2016,73739,71117,2622
Alabama,Marengo,2016,7703,7155,548
Puerto Rico,Maricao Municipio,2016,1955,1657,298
Arizona,Maricopa,2016,2077868,1983062,94806
Missouri,Maries,2016,3916,3719,197
California,Marin,2016,139619,135040,4579
Wisconsin,Marinette,2016,20266,19157,1109
Alabama,Marion,2016,12547,11720,827
Arkansas,Marion,2016,6511,6251,260
Florida,Marion,2016,131780,124145,7635
Georgia,Marion,2016,3374,3127,247
Iowa,Marion,2016,17400,16875,525
Illinois,Marion,2016,18026,16875,1151
Indiana,Marion,2016,481434,459887,21547
Kansas,Marion,2016,6114,5873,241
Kentucky,Marion,2016,9400,8999,401
Missouri,Marion,2016,14597,13972,625
Mississippi,Marion,2016,10271,9601,670
Ohio,Marion,2016,27729,26312,1417
Oregon,Marion,2016,157354,149396,7958
South Carolina,Marion,2016,12704,11592,1112
Tennessee,Marion,2016,11878,11133,745
Texas,Marion,2016,4340,4036,304
West Virginia,Marion,2016,25662,23982,1680
California,Mariposa,2016,7567,7048,519
South Carolina,Marlboro,2016,9329,8542,787
Michigan,Marquette,2016,33309,31408,1901
Wisconsin,Marquette,2016,7566,7182,384
Alabama,Marshall,2016,41754,39535,2219
Iowa,Marshall,2016,19085,18150,935
Illinois,Marshall,2016,5631,5257,374
Indiana,Marshall,2016,24324,23412,912
Kansas,Marshall,2016,5556,5388,168
Kentucky,Marshall,2016,14910,14039,871
Minnesota,Marshall,2016,5636,5225,411
Mississippi,Marshall,2016,14566,13692,874
Oklahoma,Marshall,2016,6621,6287,334
South Dakota,Marshall,2016,2460,2365,95
Tennessee,Marshall,2016,15020,14329,691
West Virginia,Marshall,2016,14061,12939,1122
Florida,Martin,2016,70764,67350,3414
Indiana,Martin,2016,5150,4939,211
Kentucky,Martin,2016,3085,2765,320
Minnesota,Martin,2016,10497,10066,431
North Carolina,Martin,2016,9814,9152,662
Texas,Martin,2016,2481,2372,109
Virginia,Martinsville city,2016,5157,4789,368
Illinois,Mason,2016,6439,5979,460
Kentucky,Mason,2016,7138,6679,459
Michigan,Mason,2016,14271,13440,831
Texas,Mason,2016,1790,1725,65
Washington,Mason,2016,23464,21690,1774
West Virginia,Mason,2016,10027,9311,716
Illinois,Massac,2016,5992,5564,428
Texas,Matagorda,2016,16874,15642,1232
Alaska,Matanuska-Susitna Borough,2016,47351,43455,3896
Virginia,Mathews,2016,4034,3871,163
Hawaii,Maui,2016,87215,84564,2651
Puerto Rico,Maunabo Municipio,2016,3020,2466,554
Tennessee,Maury,2016,43933,42164,1769
Texas,Maverick,2016,24222,21505,2717
Puerto Rico,Mayaguez Municipio,2016,23225,20039,3186
Oklahoma,Mayes,2016,19460,18470,990
Oklahoma,McClain,2016,18976,18197,779
Montana,McCone,2016,1044,1024,20
South Dakota,McCook,2016,3132,3055,77
South Carolina,McCormick,2016,3398,3208,190
Kentucky,McCracken,2016,29002,27318,1684
Kentucky,McCreary,2016,4603,4229,374
Texas,McCulloch,2016,3709,3543,166
Oklahoma,McCurtain,2016,14822,13764,1058
Missouri,McDonald,2016,10492,10036,456
Illinois,McDonough,2016,14027,13147,880
North Carolina,McDowell,2016,21015,20008,1007
West Virginia,McDowell,2016,5083,4464,619
Georgia,McDuffie,2016,8786,8144,642
Illinois,McHenry,2016,167654,158888,8766
North Dakota,McHenry,2016,3374,3209,165
Georgia,McIntosh,2016,5994,5644,350
North Dakota,McIntosh,2016,1240,1202,38
Oklahoma,McIntosh,2016,7066,6437,629
Pennsylvania,McKean,2016,18484,17263,1221
North Dakota,McKenzie,2016,7943,7644,299
New Mexico,McKinley,2016,24375,22120,2255
Illinois,McLean,2016,90527,85947,4580
Kentucky,McLean,2016,4331,4121,210
North Dakota,McLean,2016,5066,4890,176
Texas,McLennan,2016,116053,111471,4582
Minnesota,McLeod,2016,19843,18969,874
Tennessee,McMinn,2016,22679,21451,1228
Texas,McMullen,2016,861,843,18
Tennessee,McNairy,2016,8734,8122,612
Kansas,McPherson,2016,16321,15806,515
Nebraska,McPherson,2016,463,452,11
South Dakota,McPherson,2016,1088,1051,37
Kansas,Meade,2016,2374,2310,64
Kentucky,Meade,2016,12088,11461,627
South Dakota,Meade,2016,13675,13246,429
Montana,Meagher,2016,917,880,37
North Carolina,Mecklenburg,2016,583478,555878,27600
Virginia,Mecklenburg,2016,12445,11738,707
Michigan,Mecosta,2016,19098,18024,1074
Ohio,Medina,2016,96746,92570,4176
Texas,Medina,2016,20982,20060,922
Minnesota,Meeker,2016,13306,12710,596
Ohio,Meigs,2016,8951,8183,768
Tennessee,Meigs,2016,4880,4548,332
South Dakota,Mellette,2016,770,738,32
Illinois,Menard,2016,6747,6431,316
Texas,Menard,2016,816,780,36
California,Mendocino,2016,39609,37521,2088
Kentucky,Menifee,2016,2393,2185,208
Michigan,Menominee,2016,11247,10666,581
Wisconsin,Menominee,2016,1577,1457,120
California,Merced,2016,114296,102212,12084
Illinois,Mercer,2016,8222,7711,511
Kentucky,Mercer,2016,9888,9406,482
Missouri,Mercer,2016,1932,1843,89
North Dakota,Mercer,2016,4651,4447,204
New Jersey,Mercer,2016,198103,189516,8587
Ohio,Mercer,2016,23415,22645,770
Pennsylvania,Mercer,2016,52515,49387,3128
West Virginia,Mercer,2016,21680,20228,1452
Georgia,Meriwether,2016,8743,8143,600
Nebraska,Merrick,2016,4029,3884,145
New Hampshire,Merrimack,2016,81926,79835,2091
Colorado,Mesa,2016,72056,68215,3841
Kentucky,Metcalfe,2016,4119,3929,190
Indiana,Miami,2016,16085,15326,759
Kansas,Miami,2016,17003,16296,707
Ohio,Miami,2016,52992,50669,2323
Florida,Miami-Dade,2016,1313067,1244190,68877
Connecticut,Middlesex,2016,92277,88179,4098
Massachusetts,Middlesex,2016,873687,846042,27645
New Jersey,Middlesex,2016,435237,415904,19333
Virginia,Middlesex,2016,5021,4827,194
Michigan,Midland,2016,41012,39079,1933
Texas,Midland,2016,85010,81271,3739
Pennsylvania,Mifflin,2016,20798,19611,1187
Texas,Milam,2016,10263,9735,528
Utah,Millard,2016,6212,6005,207
#N/A,Mille,MN,2016,12765,12006
Arkansas,Miller,2016,19837,19007,830
Georgia,Miller,2016,2748,2600,148
Missouri,Miller,2016,11902,11286,616
Iowa,Mills,2016,7387,7118,269
Texas,Mills,2016,1924,1844,80
Wisconsin,Milwaukee,2016,477381,453685,23696
South Dakota,Miner,2016,1201,1169,32
Colorado,Mineral,2016,463,453,10
Montana,Mineral,2016,1688,1560,128
Nevada,Mineral,2016,2011,1883,128
West Virginia,Mineral,2016,11905,11195,710
West Virginia,Mingo,2016,6726,5877,849
Idaho,Minidoka,2016,10893,10545,348
South Dakota,Minnehaha,2016,107702,104943,2759
Michigan,Missaukee,2016,7023,6605,418
Arkansas,Mississippi,2016,18039,16817,1222
Missouri,Mississippi,2016,6225,5812,413
Montana,Missoula,2016,61457,59156,2301
Georgia,Mitchell,2016,8555,7994,561
Iowa,Mitchell,2016,5864,5710,154
Kansas,Mitchell,2016,3692,3570,122
North Carolina,Mitchell,2016,6188,5810,378
Texas,Mitchell,2016,2608,2425,183
Alabama,Mobile,2016,188542,176094,12448
Puerto Rico,Moca Municipio,2016,10745,9073,1672
California,Modoc,2016,3291,3034,257
Colorado,Moffat,2016,7177,6892,285
Arizona,Mohave,2016,80396,75095,5301
Missouri,Moniteau,2016,7483,7158,325
New Jersey,Monmouth,2016,325773,311239,14534
California,Mono,2016,8363,7915,448
Iowa,Monona,2016,4713,4520,193
West Virginia,Monongalia,2016,51263,49043,2220
Alabama,Monroe,2016,7344,6681,663
Arkansas,Monroe,2016,2876,2738,138
Florida,Monroe,2016,46367,44898,1469
Georgia,Monroe,2016,12997,12326,671
Iowa,Monroe,2016,3947,3765,182
Illinois,Monroe,2016,18486,17735,751
Indiana,Monroe,2016,67986,64824,3162
Kentucky,Monroe,2016,4600,4405,195
Michigan,Monroe,2016,76387,73088,3299
Missouri,Monroe,2016,4169,3967,202
Mississippi,Monroe,2016,15648,14666,982
New York,Monroe,2016,363191,346126,17065
Ohio,Monroe,2016,5319,4724,595
Pennsylvania,Monroe,2016,81855,76753,5102
Tennessee,Monroe,2016,19335,18317,1018
Wisconsin,Monroe,2016,23063,22183,880
West Virginia,Monroe,2016,5976,5704,272
Texas,Montague,2016,9028,8582,446
Michigan,Montcalm,2016,27911,26432,1479
California,Monterey,2016,218730,201975,16755
Colorado,Montezuma,2016,12717,12085,632
Alabama,Montgomery,2016,106190,100202,5988
Arkansas,Montgomery,2016,3123,2963,160
Georgia,Montgomery,2016,3719,3442,277
Iowa,Montgomery,2016,5099,4919,180
Illinois,Montgomery,2016,12110,11250,860
Indiana,Montgomery,2016,19156,18419,737
Kansas,Montgomery,2016,15982,15002,980
Kentucky,Montgomery,2016,11854,11086,768
Maryland,Montgomery,2016,546204,527278,18926
Missouri,Montgomery,2016,5758,5495,263
Mississippi,Montgomery,2016,4240,3970,270
North Carolina,Montgomery,2016,11700,11097,603
New York,Montgomery,2016,22302,21027,1275
Ohio,Montgomery,2016,249967,237552,12415
Pennsylvania,Montgomery,2016,447250,428784,18466
Tennessee,Montgomery,2016,79683,75637,4046
Texas,Montgomery,2016,265773,252769,13004
Virginia,Montgomery,2016,49664,47588,2076
Michigan,Montmorency,2016,3059,2748,311
Pennsylvania,Montour,2016,9124,8735,389
Colorado,Montrose,2016,20054,19224,830
South Dakota,Moody,2016,3949,3805,144
North Carolina,Moore,2016,39513,37533,1980
Tennessee,Moore,2016,3374,3247,127
Texas,Moore,2016,11188,10857,331
New Mexico,Mora,2016,2237,2044,193
Louisiana,Morehouse Parish,2016,10621,9591,1030
Alabama,Morgan,2016,55092,52056,3036
Colorado,Morgan,2016,15027,14508,519
Georgia,Morgan,2016,8685,8247,438
Illinois,Morgan,2016,16935,16098,837
Indiana,Morgan,2016,36037,34503,1534
Kentucky,Morgan,2016,4486,4124,362
Missouri,Morgan,2016,7980,7511,469
Ohio,Morgan,2016,6751,6188,563
Tennessee,Morgan,2016,7776,7276,500
Utah,Morgan,2016,5142,4989,153
West Virginia,Morgan,2016,7652,7316,336
Puerto Rico,Morovis Municipio,2016,8119,7027,1092
Nebraska,Morrill,2016,2645,2561,84
Kansas,Morris,2016,3047,2930,117
New Jersey,Morris,2016,258177,248057,10120
Texas,Morris,2016,4891,4357,534
Minnesota,Morrison,2016,17925,16922,1003
Ohio,Morrow,2016,16761,15909,852
Oregon,Morrow,2016,5765,5485,280
Kansas,Morton,2016,1342,1290,52
North Dakota,Morton,2016,16786,16239,547
Texas,Motley,2016,508,490,18
Illinois,Moultrie,2016,7444,7103,341
North Dakota,Mountrail,2016,7128,6916,212
Minnesota,Mower,2016,20589,19938,651
Kentucky,Muhlenberg,2016,11363,10526,837
Oregon,Multnomah,2016,443744,425011,18733
Georgia,Murray,2016,15618,14511,1107
Minnesota,Murray,2016,4973,4738,235
Oklahoma,Murray,2016,6350,6064,286
Iowa,Muscatine,2016,22372,21520,852
Georgia,Muscogee,2016,78298,72985,5313
Michigan,Muskegon,2016,77421,73194,4227
Ohio,Muskingum,2016,39724,37314,2410
Oklahoma,Muskogee,2016,29656,28042,1614
Montana,Musselshell,2016,2297,2179,118
Texas,Nacogdoches,2016,28697,27356,1341
Puerto Rico,Naguabo Municipio,2016,8086,7089,997
Nebraska,Nance,2016,1997,1942,55
Massachusetts,Nantucket,2016,7047,6734,313
California,Napa,2016,72929,69799,3130
Puerto Rico,Naranjito Municipio,2016,7260,6319,941
North Carolina,Nash,2016,43928,41043,2885
Florida,Nassau,2016,37706,36018,1688
New York,Nassau,2016,699796,672454,27342
Louisiana,Natchitoches Parish,2016,16711,15587,1124
Wyoming,Natrona,2016,40985,38052,2933
Arizona,Navajo,2016,41267,37871,3396
Texas,Navarro,2016,22757,21807,950
Kentucky,Nelson,2016,21698,20704,994
North Dakota,Nelson,2016,1533,1481,52
Virginia,Nelson,2016,7226,6963,263
Kansas,Nemaha,2016,5890,5732,158
Nebraska,Nemaha,2016,3612,3481,131
Kansas,Neosho,2016,6050,5616,434
Mississippi,Neshoba,2016,10708,10095,613
Kansas,Ness,2016,1421,1372,49
Arkansas,Nevada,2016,3638,3504,134
California,Nevada,2016,48140,45838,2302
Delaware,New Castle,2016,293641,280645,12996
North Carolina,New Hanover,2016,116055,110586,5469
Connecticut,New Haven,2016,455797,430672,25125
Virginia,New Kent,2016,11656,11257,399
Connecticut,New London,2016,136035,129057,6978
Missouri,New Madrid,2016,8256,7488,768
New York,New York,2016,914469,872736,41733
Michigan,Newaygo,2016,23322,22181,1141
South Carolina,Newberry,2016,19222,18365,857
Rhode Island,Newport,2016,44233,42154,2079
Virginia,Newport News city,2016,88729,84133,4596
Arkansas,Newton,2016,3407,3274,133
Georgia,Newton,2016,49918,46931,2987
Indiana,Newton,2016,7037,6644,393
Missouri,Newton,2016,28266,27031,1235
Mississippi,Newton,2016,8647,8140,507
Texas,Newton,2016,5349,4926,423
Idaho,Nez Perce,2016,20902,20216,686
New York,Niagara,2016,100198,94366,5832
Kentucky,Nicholas,2016,3219,3032,187
West Virginia,Nicholas,2016,9584,8738,846
Minnesota,Nicollet,2016,20424,19847,577
Wyoming,Niobrara,2016,1338,1294,44
Indiana,Noble,2016,23329,22382,947
Ohio,Noble,2016,4891,4462,429
Oklahoma,Noble,2016,5766,5562,204
Minnesota,Nobles,2016,11495,11062,433
Missouri,Nodaway,2016,10869,10361,508
Texas,Nolan,2016,6862,6533,329
Alaska,Nome Census Area,2016,4079,3561,518
Massachusetts,Norfolk,2016,372620,360049,12571
Virginia,Norfolk city,2016,110210,104327,5883
Minnesota,Norman,2016,3454,3289,165
Alaska,North Slope Borough,2016,3948,3681,267
North Carolina,Northampton,2016,7816,7249,567
Pennsylvania,Northampton,2016,158776,150594,8182
Virginia,Northampton,2016,5869,5525,344
Pennsylvania,Northumberland,2016,43937,41200,2737
Virginia,Northumberland,2016,5442,5142,300
Alaska,Northwest Arctic Borough,2016,2960,2487,473
Kansas,Norton,2016,2869,2799,70
Virginia,Norton city,2016,1659,1544,115
Virginia,Nottoway,2016,7026,6743,283
Oklahoma,Nowata,2016,4692,4406,286
Mississippi,Noxubee,2016,3967,3640,327
Nebraska,Nuckolls,2016,2363,2295,68
Texas,Nueces,2016,167680,158247,9433
Nevada,Nye,2016,16025,14852,1173
Michigan,Oakland,2016,653664,626554,27110
Tennessee,Obion,2016,12525,11645,880
Iowa,O'Brien,2016,8338,8107,231
New Jersey,Ocean,2016,267316,253333,13983
Michigan,Oceana,2016,12318,11415,903
Texas,Ochiltree,2016,4660,4416,244
Georgia,Oconee,2016,18445,17690,755
South Carolina,Oconee,2016,34279,32504,1775
Wisconsin,Oconto,2016,20496,19591,905
Michigan,Ogemaw,2016,8234,7592,642
#N/A,Oglala,SD,2016,3611,3224
Illinois,Ogle,2016,25791,24265,1526
Georgia,Oglethorpe,2016,6908,6572,336
Indiana,Ohio,2016,3226,3067,159
Kentucky,Ohio,2016,9524,8882,642
West Virginia,Ohio,2016,20621,19476,1145
Florida,Okaloosa,2016,93070,89347,3723
Washington,Okanogan,2016,21373,19946,1427
Florida,Okeechobee,2016,18113,17187,926
Oklahoma,Okfuskee,2016,4557,4280,277
Oklahoma,Oklahoma,2016,375442,359374,16068
Oklahoma,Okmulgee,2016,16169,15010,1159
Mississippi,Oktibbeha,2016,23069,21823,1246
Kentucky,Oldham,2016,31913,30822,1091
Texas,Oldham,2016,908,881,27
North Dakota,Oliver,2016,898,849,49
Minnesota,Olmsted,2016,85507,82964,2543
Idaho,Oneida,2016,2204,2125,79
New York,Oneida,2016,101631,96711,4920
Wisconsin,Oneida,2016,18617,17713,904
New York,Onondaga,2016,221119,211142,9977
North Carolina,Onslow,2016,63719,60214,3505
New York,Ontario,2016,55054,52680,2374
Michigan,Ontonagon,2016,2202,2014,188
California,Orange,2016,1597258,1532720,64538
Florida,Orange,2016,705308,674711,30597
Indiana,Orange,2016,8880,8429,451
North Carolina,Orange,2016,74933,71765,3168
New York,Orange,2016,178863,171135,7728
Texas,Orange,2016,37334,34835,2499
Virginia,Orange,2016,16341,15670,671
Vermont,Orange,2016,15900,15407,493
South Carolina,Orangeburg,2016,35681,32503,3178
Missouri,Oregon,2016,4121,3874,247
New York,Orleans,2016,17745,16731,1014
Vermont,Orleans,2016,13537,12828,709
Louisiana,Orleans Parish,2016,179955,169401,10554
Puerto Rico,Orocovis Municipio,2016,5204,4397,807
Kansas,Osage,2016,8049,7694,355
Missouri,Osage,2016,7238,6992,246
Oklahoma,Osage,2016,21089,19877,1212
Kansas,Osborne,2016,2057,1987,70
Florida,Osceola,2016,163954,155857,8097
Iowa,Osceola,2016,3633,3537,96
Michigan,Osceola,2016,10429,9834,595
Michigan,Oscoda,2016,2906,2693,213
New York,Oswego,2016,53286,49847,3439
Colorado,Otero,2016,8109,7727,382
New Mexico,Otero,2016,25473,23949,1524
Nebraska,Otoe,2016,8251,7971,280
Michigan,Otsego,2016,11684,10988,696
New York,Otsego,2016,28197,26812,1385
Kansas,Ottawa,2016,3159,3039,120
Michigan,Ottawa,2016,155338,150104,5234
Ohio,Ottawa,2016,21024,19659,1365
Oklahoma,Ottawa,2016,14480,13754,726
Minnesota,Otter Tail,2016,31400,30036,1364
Arkansas,Ouachita,2016,9864,9369,495
Louisiana,Ouachita Parish,2016,71551,67199,4352
Colorado,Ouray,2016,2164,2083,81
Wisconsin,Outagamie,2016,104042,100371,3671
Tennessee,Overton,2016,9183,8693,490
Indiana,Owen,2016,9259,8744,515
Kentucky,Owen,2016,5488,5250,238
Kentucky,Owsley,2016,1122,1011,111
Idaho,Owyhee,2016,5289,5047,242
Maine,Oxford,2016,26522,25297,1225
Missouri,Ozark,2016,3636,3372,264
Wisconsin,Ozaukee,2016,49120,47484,1636
Washington,Pacific,2016,8277,7609,668
Iowa,Page,2016,6450,6126,324
Virginia,Page,2016,11581,10930,651
Florida,Palm Beach,2016,707957,674875,33082
Iowa,Palo Alto,2016,4953,4799,154
Texas,Palo Pinto,2016,13244,12522,722
North Carolina,Pamlico,2016,5408,5123,285
Mississippi,Panola,2016,13192,12226,966
Texas,Panola,2016,10225,9493,732
Colorado,Park,2016,9826,9552,274
Montana,Park,2016,8417,8057,360
Wyoming,Park,2016,15922,15167,755
Indiana,Parke,2016,7267,6888,379
Texas,Parker,2016,61245,58758,2487
Texas,Parmer,2016,4946,4822,124
Florida,Pasco,2016,222107,210767,11340
North Carolina,Pasquotank,2016,17397,16305,1092
New Jersey,Passaic,2016,243597,228552,15045
Puerto Rico,Patillas Municipio,2016,4813,3820,993
Virginia,Patrick,2016,7943,7554,389
Georgia,Paulding,2016,79521,75847,3674
Ohio,Paulding,2016,8872,8462,410
Kansas,Pawnee,2016,3206,3100,106
Nebraska,Pawnee,2016,1651,1614,37
Oklahoma,Pawnee,2016,7498,7002,496
Idaho,Payette,2016,11275,10752,523
Oklahoma,Payne,2016,38944,37500,1444
Georgia,Peach,2016,11420,10621,799
Mississippi,Pearl River,2016,23234,21853,1381
Texas,Pecos,2016,6493,6112,381
North Dakota,Pembina,2016,3658,3475,183
Missouri,Pemiscot,2016,7044,6418,626
Washington,Pend Oreille,2016,4654,4238,416
North Carolina,Pender,2016,26852,25433,1419
Kentucky,Pendleton,2016,6849,6518,331
West Virginia,Pendleton,2016,3653,3511,142
Minnesota,Pennington,2016,9074,8553,521
South Dakota,Pennington,2016,54706,53024,1682
Maine,Penobscot,2016,76854,73529,3325
Puerto Rico,Penuelas Municipio,2016,6120,5099,1021
Illinois,Peoria,2016,88039,81962,6077
Wisconsin,Pepin,2016,4174,4015,159
Nebraska,Perkins,2016,1817,1778,39
South Dakota,Perkins,2016,1577,1532,45
North Carolina,Perquimans,2016,5101,4773,328
Alabama,Perry,2016,3481,3123,358
Arkansas,Perry,2016,4161,3962,199
Illinois,Perry,2016,8705,8086,619
Indiana,Perry,2016,9460,9029,431
Kentucky,Perry,2016,8557,7624,933
Missouri,Perry,2016,10095,9735,360
Mississippi,Perry,2016,4360,4050,310
Ohio,Perry,2016,15885,14866,1019
Pennsylvania,Perry,2016,24276,23158,1118
Tennessee,Perry,2016,3179,2978,201
Nevada,Pershing,2016,2458,2313,145
North Carolina,Person,2016,18036,17048,988
Alaska,Petersburg Borough,2016,1449,1318,131
Virginia,Petersburg city,2016,13193,12148,1045
Montana,Petroleum,2016,278,265,13
Missouri,Pettis,2016,20659,19639,1020
Missouri,Phelps,2016,19539,18610,929
Nebraska,Phelps,2016,4923,4800,123
Pennsylvania,Philadelphia/city,2016,703114,655667,47447
Arkansas,Phillips,2016,6645,6254,391
Colorado,Phillips,2016,2470,2421,49
Kansas,Phillips,2016,2854,2764,90
Montana,Phillips,2016,1938,1835,103
Illinois,Piatt,2016,8691,8269,422
Ohio,Pickaway,2016,26194,24921,1273
Alabama,Pickens,2016,7798,7265,533
Georgia,Pickens,2016,14379,13680,699
South Carolina,Pickens,2016,56452,53633,2819
Tennessee,Pickett,2016,2318,2165,153
Georgia,Pierce,2016,8542,8090,452
North Dakota,Pierce,2016,1897,1822,75
Nebraska,Pierce,2016,4141,4032,109
Washington,Pierce,2016,403890,379561,24329
Wisconsin,Pierce,2016,24722,23723,999
Alabama,Pike,2016,15009,14038,971
Arkansas,Pike,2016,4214,4035,179
Georgia,Pike,2016,8389,7954,435
Illinois,Pike,2016,7508,7125,383
Indiana,Pike,2016,6330,6055,275
Kentucky,Pike,2016,20245,18029,2216
Missouri,Pike,2016,8078,7714,364
Mississippi,Pike,2016,14681,13689,992
Ohio,Pike,2016,10804,9988,816
Pennsylvania,Pike,2016,24902,23317,1585
Arizona,Pima,2016,469004,445827,23177
Arizona,Pinal,2016,163726,154681,9045
Minnesota,Pine,2016,14887,14020,867
Florida,Pinellas,2016,477373,456719,20654
Minnesota,Pipestone,2016,4918,4731,187
Maine,Piscataquis,2016,7462,7092,370
Colorado,Pitkin,2016,10728,10365,363
North Carolina,Pitt,2016,88213,83304,4909
Oklahoma,Pittsburg,2016,17648,16566,1082
Virginia,Pittsylvania,2016,29660,28236,1424
Utah,Piute,2016,458,431,27
California,Placer,2016,179604,171549,8055
Louisiana,Plaquemines Parish,2016,10184,9639,545
Missouri,Platte,2016,56800,54742,2058
Nebraska,Platte,2016,16953,16364,589
Wyoming,Platte,2016,4772,4542,230
West Virginia,Pleasants,2016,2953,2711,242
California,Plumas,2016,7848,7085,763
Iowa,Plymouth,2016,14968,14585,383
Massachusetts,Plymouth,2016,270868,259853,11015
Iowa,Pocahontas,2016,4305,4182,123
West Virginia,Pocahontas,2016,3725,3477,248
Arkansas,Poinsett,2016,10075,9645,430
Louisiana,Pointe Coupee Parish,2016,9960,9314,646
Arkansas,Polk,2016,8168,7770,398
Florida,Polk,2016,286350,270598,15752
Georgia,Polk,2016,18042,16935,1107
Iowa,Polk,2016,256655,247743,8912
Minnesota,Polk,2016,17205,16459,746
Missouri,Polk,2016,14245,13551,694
North Carolina,Polk,2016,8825,8416,409
Nebraska,Polk,2016,2878,2802,76
Oregon,Polk,2016,38318,36384,1934
Tennessee,Polk,2016,7364,6943,421
Texas,Polk,2016,17372,16276,1096
Wisconsin,Polk,2016,24921,23780,1141
Puerto Rico,Ponce Municipio,2016,47812,41397,6415
Montana,Pondera,2016,2868,2747,121
Mississippi,Pontotoc,2016,14446,13766,680
Oklahoma,Pontotoc,2016,18473,17722,751
Arkansas,Pope,2016,29234,27893,1341
Illinois,Pope,2016,1761,1640,121
Minnesota,Pope,2016,6324,6100,224
Virginia,Poquoson city,2016,6158,5940,218
Ohio,Portage,2016,87094,82692,4402
Wisconsin,Portage,2016,39555,38046,1509
Indiana,Porter,2016,86273,81852,4421
Virginia,Portsmouth city,2016,44012,41279,2733
Indiana,Posey,2016,13450,12919,531
Kansas,Pottawatomie,2016,12138,11714,424
Oklahoma,Pottawatomie,2016,33090,31563,1527
Iowa,Pottawattamie,2016,48137,46503,1634
Pennsylvania,Potter,2016,7378,6800,578
South Dakota,Potter,2016,1157,1126,31
Texas,Potter,2016,56133,54257,1876
Montana,Powder River,2016,1068,1043,25
Kentucky,Powell,2016,4959,4601,358
Montana,Powell,2016,2870,2726,144
Idaho,Power,2016,3937,3776,161
Iowa,Poweshiek,2016,10395,10038,357
Virginia,Powhatan,2016,13618,13130,488
Arkansas,Prairie,2016,3644,3505,139
Montana,Prairie,2016,527,509,18
Kansas,Pratt,2016,5098,4891,207
Ohio,Preble,2016,21012,20004,1008
Mississippi,Prentiss,2016,11069,10468,601
Texas,Presidio,2016,3078,2749,329
Michigan,Presque Isle,2016,5286,4780,506
West Virginia,Preston,2016,14847,13993,854
Wisconsin,Price,2016,6894,6598,296
Virginia,Prince Edward,2016,10142,9596,546
Virginia,Prince George,2016,14913,14180,733
Maryland,Prince George's,2016,501485,479096,22389
Alaska,Prince of Wales-Hyder Census Area,2016,2765,2428,337
Virginia,Prince William,2016,234634,225991,8643
Rhode Island,Providence,2016,323192,305351,17841
Colorado,Prowers,2016,6000,5806,194
Colorado,Pueblo,2016,73046,69551,3495
Arkansas,Pulaski,2016,186810,180191,6619
Georgia,Pulaski,2016,4032,3796,236
Illinois,Pulaski,2016,2194,2008,186
Indiana,Pulaski,2016,6379,6094,285
Kentucky,Pulaski,2016,25382,23989,1393
Missouri,Pulaski,2016,14501,13713,788
Virginia,Pulaski,2016,16252,15273,979
Oklahoma,Pushmataha,2016,4880,4525,355
Florida,Putnam,2016,26926,25221,1705
Georgia,Putnam,2016,7939,7381,558
Illinois,Putnam,2016,3107,2933,174
Indiana,Putnam,2016,16604,15854,750
Missouri,Putnam,2016,2458,2346,112
New York,Putnam,2016,50674,48657,2017
Ohio,Putnam,2016,18893,18197,696
Tennessee,Putnam,2016,33140,31521,1619
West Virginia,Putnam,2016,25765,24505,1260
New Mexico,Quay,2016,3210,2994,216
Puerto Rico,Quebradillas Municipio,2016,6079,5109,970
Maryland,Queen Anne's,2016,26647,25601,1046
New York,Queens,2016,1158611,1105906,52705
Georgia,Quitman,2016,813,754,59
Mississippi,Quitman,2016,2618,2364,254
Georgia,Rabun,2016,6687,6292,395
Wisconsin,Racine,2016,99890,94975,4915
Virginia,Radford city,2016,8248,7797,451
Texas,Rains,2016,5551,5329,222
West Virginia,Raleigh,2016,29925,27831,2094
Missouri,Ralls,2016,5636,5409,227
Minnesota,Ramsey,2016,283359,273167,10192
North Dakota,Ramsey,2016,6143,5968,175
Texas,Randall,2016,70631,68549,2082
Alabama,Randolph,2016,9467,8941,526
Arkansas,Randolph,2016,6513,6213,300
Georgia,Randolph,2016,2469,2261,208
Illinois,Randolph,2016,14548,13819,729
Indiana,Randolph,2016,12668,12098,570
Missouri,Randolph,2016,10511,9959,552
North Carolina,Randolph,2016,66894,63603,3291
West Virginia,Randolph,2016,12201,11470,731
Mississippi,Rankin,2016,74995,72044,2951
North Dakota,Ransom,2016,2838,2774,64
Louisiana,Rapides Parish,2016,57272,53741,3531
Virginia,Rappahannock,2016,3706,3574,132
Montana,Ravalli,2016,19593,18653,940
Kansas,Rawlins,2016,1543,1506,37
Missouri,Ray,2016,11165,10615,550
Texas,Reagan,2016,1701,1596,105
Texas,Real,2016,1041,982,59
#N/A,Red,MN,2016,2297,2129
Texas,Red River,2016,5031,4740,291
Louisiana,Red River Parish,2016,3808,3579,229
Nebraska,Red Willow,2016,5968,5800,168
Minnesota,Redwood,2016,8349,8007,342
Texas,Reeves,2016,6031,5711,320
Texas,Refugio,2016,3134,2927,207
Kansas,Reno,2016,30104,28778,1326
New York,Rensselaer,2016,81541,78055,3486
Minnesota,Renville,2016,8444,8001,443
North Dakota,Renville,2016,1307,1257,50
Kansas,Republic,2016,2541,2471,70
Missouri,Reynolds,2016,2687,2513,174
Tennessee,Rhea,2016,13426,12475,951
Kansas,Rice,2016,5299,5088,211
Minnesota,Rice,2016,36228,34960,1268
Utah,Rich,2016,1095,1060,35
Nebraska,Richardson,2016,4233,4096,137
Illinois,Richland,2016,7540,7093,447
Montana,Richland,2016,6219,5911,308
North Dakota,Richland,2016,8899,8655,244
Ohio,Richland,2016,53393,50416,2977
South Carolina,Richland,2016,200756,191043,9713
Wisconsin,Richland,2016,9280,8931,349
Louisiana,Richland Parish,2016,8445,7818,627
Georgia,Richmond,2016,84693,78975,5718
North Carolina,Richmond,2016,16790,15630,1160
New York,Richmond,2016,220823,209238,11585
Virginia,Richmond,2016,3903,3757,146
Virginia,Richmond city,2016,114514,109135,5379
Kansas,Riley,2016,34848,33666,1182
Puerto Rico,Rincon Municipio,2016,4631,3908,723
Iowa,Ringgold,2016,2600,2509,91
New Mexico,Rio Arriba,2016,16756,15519,1237
Colorado,Rio Blanco,2016,2736,2597,139
Colorado,Rio Grande,2016,5153,4898,255
Puerto Rico,Rio Grande Municipio,2016,17095,15303,1792
Indiana,Ripley,2016,14066,13420,646
Missouri,Ripley,2016,5345,4967,378
West Virginia,Ritchie,2016,4562,4263,299
California,Riverside,2016,1051430,987183,64247
Tennessee,Roane,2016,22780,21516,1264
West Virginia,Roane,2016,5200,4664,536
Virginia,Roanoke,2016,49068,47296,1772
Virginia,Roanoke city,2016,48871,46746,2125
South Dakota,Roberts,2016,4840,4640,200
Texas,Roberts,2016,442,422,20
Kentucky,Robertson,2016,805,755,50
Tennessee,Robertson,2016,34635,33199,1436
Texas,Robertson,2016,7253,6886,367
North Carolina,Robeson,2016,50549,46545,4004
Minnesota,Rock,2016,5930,5793,137
Nebraska,Rock,2016,890,867,23
Wisconsin,Rock,2016,84246,80545,3701
Illinois,Rock Island,2016,72081,67558,4523
Virginia,Rockbridge,2016,10448,9986,462
Kentucky,Rockcastle,2016,6683,6272,411
Georgia,Rockdale,2016,43179,40679,2500
North Carolina,Rockingham,2016,40854,38549,2305
New Hampshire,Rockingham,2016,181713,176210,5503
Virginia,Rockingham,2016,40502,39064,1438
New York,Rockland,2016,152479,146098,6381
Texas,Rockwall,2016,47329,45673,1656
Oklahoma,Roger Mills,2016,1813,1720,93
Oklahoma,Rogers,2016,44925,42673,2252
North Dakota,Rolette,2016,4983,4444,539
Kansas,Rooks,2016,2666,2540,126
Montana,Roosevelt,2016,4692,4442,250
New Mexico,Roosevelt,2016,8068,7613,455
Michigan,Roscommon,2016,7866,7200,666
Minnesota,Roseau,2016,8276,7854,422
Montana,Rosebud,2016,4111,3886,225
Ohio,Ross,2016,33827,31950,1877
Colorado,Routt,2016,14894,14504,390
Kentucky,Rowan,2016,10574,9942,632
North Carolina,Rowan,2016,64233,60664,3569
Texas,Runnels,2016,4646,4463,183
Indiana,Rush,2016,8978,8639,339
Kansas,Rush,2016,1730,1661,69
Texas,Rusk,2016,22363,21062,1301
Wisconsin,Rusk,2016,7015,6656,359
Alabama,Russell,2016,23627,22322,1305
Kansas,Russell,2016,3570,3420,150
Kentucky,Russell,2016,6138,5619,519
Virginia,Russell,2016,11231,10498,733
North Carolina,Rutherford,2016,24811,23153,1658
Tennessee,Rutherford,2016,163069,157053,6016
Vermont,Rutland,2016,31460,30277,1183
Puerto Rico,Sabana Grande Municipio,2016,6446,5424,1022
Texas,Sabine,2016,3481,3155,326
Louisiana,Sabine Parish,2016,9137,8505,632
Iowa,Sac,2016,5480,5315,165
California,Sacramento,2016,693868,656358,37510
Maine,Sagadahoc,2016,19160,18592,568
Michigan,Saginaw,2016,88569,83845,4724
Colorado,Saguache,2016,3226,3068,158
New Jersey,Salem,2016,29970,28051,1919
Virginia,Salem city,2016,12874,12362,512
Puerto Rico,Salinas Municipio,2016,7568,5928,1640
Arkansas,Saline,2016,56768,54998,1770
Illinois,Saline,2016,10050,9189,861
Kansas,Saline,2016,30078,28956,1122
Missouri,Saline,2016,10756,10254,502
Nebraska,Saline,2016,7341,7115,226
#N/A,Salt,UT,2016,601570,582448
South Carolina,Saluda,2016,8910,8504,406
North Carolina,Sampson,2016,29517,27908,1609
Texas,San Augustine,2016,2802,2552,250
California,San Benito,2016,30426,28397,2029
California,San Bernardino,2016,930088,876384,53704
California,San Diego,2016,1562997,1489140,73857
California,San Francisco/city,2016,555264,536972,18292
Puerto Rico,San German Municipio,2016,10356,8775,1581
Texas,San Jacinto,2016,11421,10706,715
California,San Joaquin,2016,318233,292367,25866
Colorado,San Juan,2016,479,461,18
New Mexico,San Juan,2016,54211,49510,4701
Utah,San Juan,2016,5742,5278,464
Washington,San Juan,2016,7860,7491,369
Puerto Rico,San Juan Municipio,2016,135159,124495,10664
Puerto Rico,San Lorenzo Municipio,2016,11910,10418,1492
California,San Luis Obispo,2016,139465,133437,6028
California,San Mateo,2016,441754,428282,13472
Colorado,San Miguel,2016,5181,5012,169
New Mexico,San Miguel,2016,11088,10245,843
Texas,San Patricio,2016,30594,28316,2278
Texas,San Saba,2016,2447,2364,83
Puerto Rico,San Sebastian Municipio,2016,10721,8694,2027
South Dakota,Sanborn,2016,1209,1173,36
Montana,Sanders,2016,4759,4391,368
New Mexico,Sandoval,2016,64093,59921,4172
Ohio,Sandusky,2016,31014,29541,1473
Illinois,Sangamon,2016,103862,98686,5176
Michigan,Sanilac,2016,19407,18199,1208
Utah,Sanpete,2016,11799,11328,471
California,Santa Barbara,2016,215220,204328,10892
California,Santa Clara,2016,1027805,989046,38759
Arizona,Santa Cruz,2016,19161,17244,1917
California,Santa Cruz,2016,143726,133730,9996
New Mexico,Santa Fe,2016,73496,69657,3839
Puerto Rico,Santa Isabel Municipio,2016,9898,8244,1654
Florida,Santa Rosa,2016,75987,72574,3413
Florida,Sarasota,2016,180693,172515,8178
New York,Saratoga,2016,117440,112961,4479
North Dakota,Sargent,2016,2331,2286,45
Nebraska,Sarpy,2016,91943,89269,2674
Wisconsin,Sauk,2016,35291,34033,1258
Nebraska,Saunders,2016,10860,10527,333
Wisconsin,Sawyer,2016,7933,7438,495
New York,Schenectady,2016,75764,72482,3282
Texas,Schleicher,2016,1420,1346,74
Georgia,Schley,2016,2113,1980,133
New York,Schoharie,2016,14720,13921,799
Michigan,Schoolcraft,2016,3388,3079,309
Illinois,Schuyler,2016,3358,3169,189
Missouri,Schuyler,2016,1909,1788,121
New York,Schuyler,2016,8275,7777,498
Pennsylvania,Schuylkill,2016,67544,63377,4167
Ohio,Scioto,2016,29868,27543,2325
Missouri,Scotland,2016,2459,2357,102
North Carolina,Scotland,2016,11635,10574,1061
Arkansas,Scott,2016,4456,4292,164
Iowa,Scott,2016,86497,82592,3905
Illinois,Scott,2016,2527,2384,143
Indiana,Scott,2016,10475,9967,508
Kansas,Scott,2016,2884,2813,71
Kentucky,Scott,2016,27978,26908,1070
Minnesota,Scott,2016,80987,78387,2600
Missouri,Scott,2016,20005,18859,1146
Mississippi,Scott,2016,13271,12665,606
Tennessee,Scott,2016,7993,7403,590
Virginia,Scott,2016,9413,8948,465
Nebraska,Scotts Bluff,2016,18821,18164,657
Georgia,Screven,2016,5229,4836,393
Texas,Scurry,2016,7404,6969,435
Arkansas,Searcy,2016,2984,2848,136
Arkansas,Sebastian,2016,57509,55370,2139
Colorado,Sedgwick,2016,1176,1149,27
Kansas,Sedgwick,2016,247016,235528,11488
Florida,Seminole,2016,241602,231320,10282
Georgia,Seminole,2016,3087,2844,243
Oklahoma,Seminole,2016,9451,8798,653
New York,Seneca,2016,15484,14747,737
Ohio,Seneca,2016,27140,25803,1337
Tennessee,Sequatchie,2016,5900,5557,343
Oklahoma,Sequoyah,2016,16857,15804,1053
Arkansas,Sevier,2016,5685,5410,275
Tennessee,Sevier,2016,51026,48508,2518
Utah,Sevier,2016,9589,9168,421
Kansas,Seward,2016,10220,9775,445
Nebraska,Seward,2016,8743,8493,250
Texas,Shackelford,2016,1876,1804,72
Missouri,Shannon,2016,3332,3087,245
Mississippi,Sharkey,2016,1715,1565,150
Arkansas,Sharp,2016,6041,5713,328
California,Shasta,2016,74190,69019,5171
Wisconsin,Shawano,2016,21328,20443,885
Kansas,Shawnee,2016,91580,87910,3670
Wisconsin,Sheboygan,2016,61829,59732,2097
Alabama,Shelby,2016,110035,105324,4711
Iowa,Shelby,2016,6805,6605,200
Illinois,Shelby,2016,10396,9800,596
Indiana,Shelby,2016,22954,22037,917
Kentucky,Shelby,2016,23797,22942,855
Missouri,Shelby,2016,3076,2947,129
Ohio,Shelby,2016,24064,23059,1005
Tennessee,Shelby,2016,432665,409622,23043
Texas,Shelby,2016,10949,10293,656
Virginia,Shenandoah,2016,20799,20008,791
Minnesota,Sherburne,2016,50867,48801,2066
Kansas,Sheridan,2016,1448,1413,35
Montana,Sheridan,2016,1962,1898,64
North Dakota,Sheridan,2016,737,695,42
Nebraska,Sheridan,2016,2735,2657,78
Wyoming,Sheridan,2016,16118,15355,763
Kansas,Sherman,2016,2938,2841,97
Nebraska,Sherman,2016,1715,1660,55
Oregon,Sherman,2016,894,853,41
Texas,Sherman,2016,1349,1310,39
Michigan,Shiawassee,2016,33477,31714,1763
Idaho,Shoshone,2016,5126,4762,364
Minnesota,Sibley,2016,8522,8158,364
California,Sierra,2016,1333,1232,101
New Mexico,Sierra,2016,4060,3721,339
Montana,Silver Bow,2016,17208,16472,736
Kentucky,Simpson,2016,8389,8011,378
Mississippi,Simpson,2016,10939,10347,592
Iowa,Sioux,2016,20631,20157,474
North Dakota,Sioux,2016,1338,1279,59
Nebraska,Sioux,2016,783,762,21
California,Siskiyou,2016,17890,16370,1520
Alaska,Sitka Borough/city,2016,4366,4164,202
Washington,Skagit,2016,57868,54089,3779
Alaska,Skagway Municipality,2016,805,715,90
Washington,Skamania,2016,5065,4713,352
North Dakota,Slope,2016,436,425,11
Kansas,Smith,2016,2031,1966,65
Mississippi,Smith,2016,6742,6389,353
Tennessee,Smith,2016,8650,8255,395
Texas,Smith,2016,105398,100638,4760
Virginia,Smyth,2016,13661,12860,801
Washington,Snohomish,2016,415507,397933,17574
Pennsylvania,Snyder,2016,20511,19552,959
New Mexico,Socorro,2016,6678,6194,484
California,Solano,2016,207235,195834,11401
Maryland,Somerset,2016,9260,8586,674
Maine,Somerset,2016,23444,22128,1316
New Jersey,Somerset,2016,172080,165098,6982
Pennsylvania,Somerset,2016,34160,31711,2449
Texas,Somervell,2016,4130,3932,198
California,Sonoma,2016,259183,248876,10307
Virginia,Southampton,2016,9024,8666,358
Alaska,Southeast Fairbanks Census Area,2016,2993,2671,322
Georgia,Spalding,2016,27746,25841,1905
South Carolina,Spartanburg,2016,142621,135864,6757
Indiana,Spencer,2016,10975,10525,450
Kentucky,Spencer,2016,9651,9281,370
South Dakota,Spink,2016,3285,3184,101
Washington,Spokane,2016,234083,219816,14267
Virginia,Spotsylvania,2016,64856,62177,2679
#N/A,St.,LA,2016,32807,30158
#N/A,St.,NY,2016,43346,40489
Louisiana,St. Bernard Parish,2016,19546,18357,1189
Missouri,St. Charles,2016,221494,213718,7776
Louisiana,St. Charles Parish,2016,25319,23975,1344
Alabama,St. Clair,2016,39241,37217,2024
Illinois,St. Clair,2016,127192,119462,7730
Michigan,St. Clair,2016,74762,70209,4553
Missouri,St. Clair,2016,3923,3677,246
Wisconsin,St. Croix,2016,49746,47872,1874
Arkansas,St. Francis,2016,8826,8368,458
Missouri,St. Francois,2016,26283,24834,1449
Louisiana,St. Helena Parish,2016,4390,4054,336
Louisiana,St. James Parish,2016,9606,8888,718
Louisiana,St. John the Baptist Parish,2016,20054,18683,1371
Florida,St. Johns,2016,118381,113922,4459
Indiana,St. Joseph,2016,134119,128039,6080
Michigan,St. Joseph,2016,29114,27913,1201
Minnesota,St. Louis,2016,102962,97080,5882
Missouri,St. Louis,2016,532537,510089,22448
Missouri,St. Louis city,2016,157649,149054,8595
Florida,St. Lucie,2016,134948,127177,7771
Louisiana,St. Martin Parish,2016,22963,21183,1780
Louisiana,St. Mary Parish,2016,21939,19880,2059
Maryland,St. Mary's,2016,54902,52562,2340
Louisiana,St. Tammany Parish,2016,117481,111641,5840
Kansas,Stafford,2016,2092,2015,77
Virginia,Stafford,2016,68200,65501,2699
California,Stanislaus,2016,242669,221770,20899
South Dakota,Stanley,2016,1870,1825,45
North Carolina,Stanly,2016,29288,27931,1357
Kansas,Stanton,2016,1070,1040,30
Nebraska,Stanton,2016,3437,3347,90
Illinois,Stark,2016,2759,2556,203
North Dakota,Stark,2016,18076,17370,706
Ohio,Stark,2016,186400,176173,10227
Indiana,Starke,2016,10858,10271,587
Texas,Starr,2016,26333,22821,3512
Virginia,Staunton city,2016,11776,11311,465
Missouri,Ste. Genevieve,2016,9004,8585,419
Minnesota,Stearns,2016,89247,85890,3357
Minnesota,Steele,2016,21262,20505,757
North Dakota,Steele,2016,1074,1051,23
Georgia,Stephens,2016,11015,10368,647
Oklahoma,Stephens,2016,19042,17237,1805
Texas,Stephens,2016,4015,3804,211
Illinois,Stephenson,2016,21407,20151,1256
Texas,Sterling,2016,669,643,26
Indiana,Steuben,2016,20081,19346,735
New York,Steuben,2016,43152,40638,2514
Kansas,Stevens,2016,2905,2790,115
Minnesota,Stevens,2016,5671,5501,170
Washington,Stevens,2016,17859,16385,1474
Georgia,Stewart,2016,2134,1998,136
Tennessee,Stewart,2016,5148,4800,348
Montana,Stillwater,2016,4815,4624,191
Missouri,Stoddard,2016,13321,12468,853
North Carolina,Stokes,2016,21874,20830,1044
Arkansas,Stone,2016,4733,4490,243
Missouri,Stone,2016,13449,12509,940
Mississippi,Stone,2016,6497,6062,435
Texas,Stonewall,2016,640,612,28
Nevada,Storey,2016,1906,1786,120
Iowa,Story,2016,56811,55478,1333
New Hampshire,Strafford,2016,72417,70572,1845
North Dakota,Stutsman,2016,11073,10800,273
Wyoming,Sublette,2016,4229,3956,273
Massachusetts,Suffolk,2016,427223,412113,15110
New York,Suffolk,2016,773871,740123,33748
Virginia,Suffolk city,2016,42908,40875,2033
Indiana,Sullivan,2016,8699,8188,511
Missouri,Sullivan,2016,2776,2616,160
New Hampshire,Sullivan,2016,23593,23044,549
New York,Sullivan,2016,34025,32399,1626
Pennsylvania,Sullivan,2016,2840,2636,204
Tennessee,Sullivan,2016,69521,65937,3584
South Dakota,Sully,2016,859,839,20
West Virginia,Summers,2016,4568,4288,280
Colorado,Summit,2016,21109,20672,437
Ohio,Summit,2016,272310,258318,13992
Utah,Summit,2016,23873,23121,752
Kansas,Sumner,2016,10920,10457,463
Tennessee,Sumner,2016,92013,88448,3565
Alabama,Sumter,2016,5131,4738,393
Florida,Sumter,2016,29330,27239,2091
Georgia,Sumter,2016,12824,11854,970
South Carolina,Sumter,2016,44351,41734,2617
Mississippi,Sunflower,2016,8344,7572,772
North Carolina,Surry,2016,33524,31924,1600
Virginia,Surry,2016,3652,3458,194
Pennsylvania,Susquehanna,2016,20859,19676,1183
Delaware,Sussex,2016,101015,96477,4538
New Jersey,Sussex,2016,74843,71312,3531
Virginia,Sussex,2016,3944,3694,250
California,Sutter,2016,44968,40613,4355
Texas,Sutton,2016,1590,1464,126
Florida,Suwannee,2016,18151,17266,885
North Carolina,Swain,2016,7118,6684,434
Montana,Sweet Grass,2016,1799,1743,56
Wyoming,Sweetwater,2016,22125,20782,1343
Minnesota,Swift,2016,5064,4792,272
Texas,Swisher,2016,2714,2599,115
Indiana,Switzerland,2016,4996,4752,244
Georgia,Talbot,2016,2740,2557,183
Maryland,Talbot,2016,19579,18755,824
Georgia,Taliaferro,2016,548,510,38
Alabama,Talladega,2016,34955,32660,2295
Mississippi,Tallahatchie,2016,5740,5352,388
Alabama,Tallapoosa,2016,18656,17620,1036
Iowa,Tama,2016,9742,9334,408
Missouri,Taney,2016,26370,24422,1948
Louisiana,Tangipahoa Parish,2016,54158,50506,3652
New Mexico,Taos,2016,14937,13694,1243
Texas,Tarrant,2016,1010694,970542,40152
Mississippi,Tate,2016,12089,11385,704
Georgia,Tattnall,2016,9316,8818,498
Florida,Taylor,2016,8820,8346,474
Georgia,Taylor,2016,3318,3070,248
Iowa,Taylor,2016,3221,3126,95
Kentucky,Taylor,2016,12215,11607,608
Texas,Taylor,2016,63271,60908,2363
Wisconsin,Taylor,2016,11098,10640,458
West Virginia,Taylor,2016,7816,7375,441
Illinois,Tazewell,2016,65774,61543,4231
Virginia,Tazewell,2016,15938,14731,1207
California,Tehama,2016,25066,23281,1785
Georgia,Telfair,2016,4805,4403,402
Colorado,Teller,2016,11723,11288,435
Louisiana,Tensas Parish,2016,1626,1467,159
Louisiana,Terrebonne Parish,2016,48948,45538,3410
Georgia,Terrell,2016,3651,3414,237
Texas,Terrell,2016,406,390,16
Texas,Terry,2016,5348,5093,255
Idaho,Teton,2016,5992,5799,193
Montana,Teton,2016,2832,2730,102
Wyoming,Teton,2016,15237,14708,529
Missouri,Texas,2016,9338,8753,585
Oklahoma,Texas,2016,9410,9092,318
Nebraska,Thayer,2016,2900,2829,71
Georgia,Thomas,2016,17504,16413,1091
Kansas,Thomas,2016,4347,4228,119
Nebraska,Thomas,2016,448,433,15
Texas,Throckmorton,2016,743,717,26
Nebraska,Thurston,2016,2976,2832,144
Washington,Thurston,2016,129543,122228,7315
Georgia,Tift,2016,18523,17527,996
Oregon,Tillamook,2016,11638,11066,572
Oklahoma,Tillman,2016,3315,3168,147
New York,Tioga,2016,23010,21829,1181
Pennsylvania,Tioga,2016,19858,18446,1412
Mississippi,Tippah,2016,9403,8883,520
Indiana,Tippecanoe,2016,94383,90548,3835
Indiana,Tipton,2016,8527,8199,328
Tennessee,Tipton,2016,27410,25857,1553
Mississippi,Tishomingo,2016,8261,7810,451
Texas,Titus,2016,12872,12080,792
Puerto Rico,Toa Alta Municipio,2016,26551,24343,2208
Puerto Rico,Toa Baja Municipio,2016,29753,27071,2682
Kentucky,Todd,2016,5302,5064,238
Minnesota,Todd,2016,12951,12342,609
South Dakota,Todd,2016,3059,2862,197
Connecticut,Tolland,2016,85320,81489,3831
Texas,Tom Green,2016,54228,51803,2425
New York,Tompkins,2016,50351,48257,2094
Utah,Tooele,2016,30826,29655,1171
Montana,Toole,2016,2228,2151,77
Georgia,Toombs,2016,11767,10849,918
New Mexico,Torrance,2016,5506,5010,496
North Dakota,Towner,2016,1332,1302,30
Georgia,Towns,2016,4102,3823,279
North Dakota,Traill,2016,4597,4469,128
North Carolina,Transylvania,2016,13959,13280,679
Minnesota,Traverse,2016,1713,1646,67
Texas,Travis,2016,677945,656425,21520
Montana,Treasure,2016,353,338,15
Kansas,Trego,2016,1474,1415,59
Wisconsin,Trempealeau,2016,16693,16077,616
Georgia,Treutlen,2016,2737,2527,210
Kentucky,Trigg,2016,5818,5490,328
Kentucky,Trimble,2016,3868,3658,210
California,Trinity,2016,4991,4638,353
Texas,Trinity,2016,5480,5147,333
South Dakota,Tripp,2016,3063,2995,68
Georgia,Troup,2016,36778,34906,1872
Tennessee,Trousdale,2016,3833,3648,185
Puerto Rico,Trujillo Alto Municipio,2016,27127,25174,1953
Ohio,Trumbull,2016,90400,84249,6151
West Virginia,Tucker,2016,3475,3287,188
California,Tulare,2016,203219,180502,22717
Oklahoma,Tulsa,2016,318525,303683,14842
Mississippi,Tunica,2016,4611,4285,326
California,Tuolumne,2016,21563,20221,1342
Georgia,Turner,2016,3230,3021,209
South Dakota,Turner,2016,4676,4546,130
Alabama,Tuscaloosa,2016,99659,94059,5600
Ohio,Tuscarawas,2016,45004,42402,2602
Michigan,Tuscola,2016,24217,22694,1523
Georgia,Twiggs,2016,2944,2688,256
Idaho,Twin Falls,2016,39633,38284,1349
Texas,Tyler,2016,7210,6684,526
West Virginia,Tyler,2016,3546,3230,316
North Carolina,Tyrrell,2016,1530,1401,129
Wyoming,Uinta,2016,9420,8871,549
Utah,Uintah,2016,14133,12814,1319
New York,Ulster,2016,88138,84242,3896
Oregon,Umatilla,2016,36004,34084,1920
Tennessee,Unicoi,2016,6987,6492,495
Arkansas,Union,2016,16346,15455,891
Florida,Union,2016,4787,4581,206
Georgia,Union,2016,10433,9939,494
Iowa,Union,2016,6497,6250,247
Illinois,Union,2016,7524,6966,558
Indiana,Union,2016,3637,3490,147
Kentucky,Union,2016,6164,5742,422
Mississippi,Union,2016,13668,13067,601
North Carolina,Union,2016,115773,110681,5092
New Jersey,Union,2016,275373,261137,14236
New Mexico,Union,2016,1894,1819,75
Ohio,Union,2016,27783,26715,1068
Oregon,Union,2016,11973,11266,707
Pennsylvania,Union,2016,19774,18830,944
South Carolina,Union,2016,11487,10772,715
South Dakota,Union,2016,8048,7798,250
Tennessee,Union,2016,7254,6836,418
Louisiana,Union Parish,2016,9242,8636,606
Texas,Upshur,2016,17887,16742,1145
West Virginia,Upshur,2016,9802,9062,740
Georgia,Upson,2016,11124,10407,717
Texas,Upton,2016,1581,1497,84
Utah,Utah,2016,278913,270282,8631
Puerto Rico,Utuado Municipio,2016,6885,5817,1068
Texas,Uvalde,2016,11803,11177,626
Texas,Val Verde,2016,20129,18874,1255
Alaska,Valdez-Cordova Census Area,2016,4804,4391,413
New Mexico,Valencia,2016,29911,27781,2130
Idaho,Valley,2016,4973,4705,268
Montana,Valley,2016,4408,4259,149
Nebraska,Valley,2016,2089,2031,58
Arkansas,Van Buren,2016,6092,5674,418
Iowa,Van Buren,2016,3849,3708,141
Michigan,Van Buren,2016,35454,33415,2039
Tennessee,Van Buren,2016,2030,1905,125
Ohio,Van Wert,2016,14300,13718,582
Texas,Van Zandt,2016,24842,23775,1067
North Carolina,Vance,2016,18004,16718,1286
Indiana,Vanderburgh,2016,93222,89389,3833
Puerto Rico,Vega Alta Municipio,2016,9878,8740,1138
Puerto Rico,Vega Baja Municipio,2016,13733,11829,1904
Pennsylvania,Venango,2016,23703,21989,1714
California,Ventura,2016,425280,403083,22197
Illinois,Vermilion,2016,34892,32361,2531
Louisiana,Vermilion Parish,2016,24701,22821,1880
Indiana,Vermillion,2016,7271,6792,479
Missouri,Vernon,2016,9624,9157,467
Wisconsin,Vernon,2016,15785,15209,576
Louisiana,Vernon Parish,2016,16928,15702,1226
Texas,Victoria,2016,43695,41329,2366
Puerto Rico,Vieques Municipio,2016,3260,2914,346
Indiana,Vigo,2016,49375,46714,2661
Wisconsin,Vilas,2016,9992,9426,566
Puerto Rico,Villalba Municipio,2016,7815,6235,1580
Ohio,Vinton,2016,5453,5066,387
Virginia,Virginia Beach city,2016,228905,219741,9164
Florida,Volusia,2016,245026,232679,12347
Illinois,Wabash,2016,5753,5392,361
Indiana,Wabash,2016,15477,14818,659
Minnesota,Wabasha,2016,12055,11611,444
Kansas,Wabaunsee,2016,3702,3570,132
Minnesota,Wadena,2016,6270,5899,371
Oklahoma,Wagoner,2016,36649,34903,1746
Washington,Wahkiakum,2016,1286,1175,111
North Carolina,Wake,2016,556706,532827,23879
Florida,Wakulla,2016,14271,13683,588
Maine,Waldo,2016,20827,19955,872
Alabama,Walker,2016,25669,23767,1902
Georgia,Walker,2016,29888,28224,1664
Texas,Walker,2016,23774,22531,1243
Washington,Walla Walla,2016,28661,27107,1554
Kansas,Wallace,2016,859,836,23
Texas,Waller,2016,22161,20925,1236
Oregon,Wallowa,2016,3315,3091,224
North Dakota,Walsh,2016,5659,5445,214
Mississippi,Walthall,2016,5039,4652,387
Florida,Walton,2016,28889,27654,1235
Georgia,Walton,2016,43313,41186,2127
South Dakota,Walworth,2016,2241,2126,115
Wisconsin,Walworth,2016,57796,55490,2306
Iowa,Wapello,2016,17846,16811,1035
North Dakota,Ward,2016,33522,32142,1380
Texas,Ward,2016,5392,5085,307
Georgia,Ware,2016,15457,14625,832
Georgia,Warren,2016,2695,2508,187
Iowa,Warren,2016,27037,26172,865
Illinois,Warren,2016,8697,8238,459
Indiana,Warren,2016,4111,3912,199
Kentucky,Warren,2016,61962,59522,2440
Missouri,Warren,2016,17526,16793,733
Mississippi,Warren,2016,20820,19508,1312
North Carolina,Warren,2016,7143,6622,521
New Jersey,Warren,2016,56302,53719,2583
New York,Warren,2016,31980,30298,1682
Ohio,Warren,2016,114558,109770,4788
Pennsylvania,Warren,2016,19769,18688,1081
Tennessee,Warren,2016,17612,16767,845
Virginia,Warren,2016,19672,18868,804
Indiana,Warrick,2016,32481,31169,1312
Utah,Wasatch,2016,13902,13431,471
Oregon,Wasco,2016,13687,13030,657
Minnesota,Waseca,2016,9499,9092,407
Wyoming,Washakie,2016,4212,4011,201
Wisconsin,Washburn,2016,7989,7591,398
Alabama,Washington,2016,6769,6188,581
Arkansas,Washington,2016,118196,114945,3251
Colorado,Washington,2016,2917,2854,63
Florida,Washington,2016,9682,9187,495
Georgia,Washington,2016,7172,6718,454
Iowa,Washington,2016,12322,11961,361
Idaho,Washington,2016,4608,4354,254
Illinois,Washington,2016,9645,9282,363
Indiana,Washington,2016,13682,13056,626
Kansas,Washington,2016,3080,2979,101
Kentucky,Washington,2016,6080,5817,263
Maryland,Washington,2016,75569,71680,3889
Maine,Washington,2016,13985,13211,774
Minnesota,Washington,2016,139295,134651,4644
Missouri,Washington,2016,10359,9702,657
Mississippi,Washington,2016,17768,16177,1591
North Carolina,Washington,2016,4865,4505,360
Nebraska,Washington,2016,11093,10739,354
New York,Washington,2016,28335,27018,1317
Ohio,Washington,2016,27769,25819,1950
Oklahoma,Washington,2016,23954,22786,1168
Oregon,Washington,2016,313325,300470,12855
Pennsylvania,Washington,2016,107218,100679,6539
Rhode Island,Washington,2016,68898,65630,3268
Tennessee,Washington,2016,58537,55747,2790
Texas,Washington,2016,15076,14311,765
Utah,Washington,2016,67252,64738,2514
Virginia,Washington,2016,26812,25590,1222
Vermont,Washington,2016,33905,32826,1079
Wisconsin,Washington,2016,77322,74739,2583
Louisiana,Washington Parish,2016,16943,15754,1189
Oklahoma,Washita,2016,5326,4958,368
Nevada,Washoe,2016,229817,218347,11470
Michigan,Washtenaw,2016,191443,184440,7003
North Carolina,Watauga,2016,27949,26695,1254
Minnesota,Watonwan,2016,6600,6279,321
Wisconsin,Waukesha,2016,225184,217425,7759
Wisconsin,Waupaca,2016,27016,25950,1066
Wisconsin,Waushara,2016,11500,10922,578
Georgia,Wayne,2016,11277,10505,772
Iowa,Wayne,2016,2833,2726,107
Illinois,Wayne,2016,7302,6679,623
Indiana,Wayne,2016,30950,29465,1485
Kentucky,Wayne,2016,7262,6700,562
Michigan,Wayne,2016,780565,731656,48909
Missouri,Wayne,2016,5668,5365,303
Mississippi,Wayne,2016,7540,6991,549
North Carolina,Wayne,2016,53556,50438,3118
Nebraska,Wayne,2016,5617,5468,149
New York,Wayne,2016,43980,41789,2191
Ohio,Wayne,2016,61196,58742,2454
Pennsylvania,Wayne,2016,22515,21225,1290
Tennessee,Wayne,2016,6067,5669,398
Utah,Wayne,2016,1428,1316,112
West Virginia,Wayne,2016,15526,14500,1026
Virginia,Waynesboro city,2016,10178,9751,427
Tennessee,Weakley,2016,15808,14886,922
Texas,Webb,2016,113792,108240,5552
Utah,Weber,2016,120114,115498,4616
Georgia,Webster,2016,965,882,83
Iowa,Webster,2016,20379,19564,815
Kentucky,Webster,2016,5832,5479,353
Missouri,Webster,2016,16929,16096,833
Mississippi,Webster,2016,3907,3665,242
Nebraska,Webster,2016,1711,1657,54
West Virginia,Webster,2016,3489,3198,291
Louisiana,Webster Parish,2016,15198,13902,1296
Colorado,Weld,2016,149828,144709,5119
Indiana,Wells,2016,14167,13662,505
North Dakota,Wells,2016,2190,2105,85
Louisiana,West Baton Rouge Parish,2016,13239,12534,705
Louisiana,West Carroll Parish,2016,4104,3613,491
Louisiana,West Feliciana Parish,2016,5328,5052,276
New York,Westchester,2016,477692,457221,20471
Pennsylvania,Westmoreland,2016,182739,172070,10669
Virginia,Westmoreland,2016,8967,8552,415
Wyoming,Weston,2016,3957,3759,198
West Virginia,Wetzel,2016,7199,6533,666
Michigan,Wexford,2016,14694,13832,862
Texas,Wharton,2016,21061,20004,1057
Washington,Whatcom,2016,106929,100688,6241
Montana,Wheatland,2016,797,757,40
Georgia,Wheeler,2016,1731,1575,156
Nebraska,Wheeler,2016,565,553,12
Oregon,Wheeler,2016,686,657,29
Texas,Wheeler,2016,2481,2364,117
Arkansas,White,2016,33984,32217,1767
Georgia,White,2016,14459,13789,670
Illinois,White,2016,6889,6437,452
Indiana,White,2016,13643,13100,543
Tennessee,White,2016,11721,11139,582
Nevada,White Pine,2016,4484,4276,208
Illinois,Whiteside,2016,28728,27061,1667
Georgia,Whitfield,2016,44669,41939,2730
Indiana,Whitley,2016,17234,16564,670
Kentucky,Whitley,2016,13350,12463,887
Washington,Whitman,2016,23064,21907,1157
Montana,Wibaux,2016,513,493,20
Kansas,Wichita,2016,1204,1176,28
Texas,Wichita,2016,55437,53035,2402
Maryland,Wicomico,2016,50562,47402,3160
Texas,Wilbarger,2016,5046,4809,237
Alabama,Wilcox,2016,2828,2422,406
Georgia,Wilcox,2016,2716,2520,196
Georgia,Wilkes,2016,3701,3456,245
North Carolina,Wilkes,2016,30204,28759,1445
Minnesota,Wilkin,2016,3733,3612,121
Georgia,Wilkinson,2016,3645,3414,231
Mississippi,Wilkinson,2016,2836,2549,287
Illinois,Will,2016,362361,340776,21585
Texas,Willacy,2016,6498,5703,795
North Dakota,Williams,2016,22621,21636,985
Ohio,Williams,2016,19018,18154,864
South Carolina,Williamsburg,2016,12497,11528,969
Virginia,Williamsburg city,2016,6705,6330,375
Illinois,Williamson,2016,32325,30336,1989
Tennessee,Williamson,2016,113165,109311,3854
Texas,Williamson,2016,278496,269165,9331
Kansas,Wilson,2016,4111,3864,247
North Carolina,Wilson,2016,36486,33517,2969
Tennessee,Wilson,2016,67595,64999,2596
Texas,Wilson,2016,23741,22815,926
Virginia,Winchester city,2016,14305,13727,578
Connecticut,Windham,2016,62764,59271,3493
Vermont,Windham,2016,23221,22449,772
Vermont,Windsor,2016,29331,28473,858
Texas,Winkler,2016,3068,2832,236
Louisiana,Winn Parish,2016,5185,4783,402
Iowa,Winnebago,2016,5185,5005,180
Illinois,Winnebago,2016,141312,131886,9426
Wisconsin,Winnebago,2016,93217,89901,3316
Iowa,Winneshiek,2016,12029,11606,423
Minnesota,Winona,2016,29365,28327,1038
Alabama,Winston,2016,9571,8895,676
Mississippi,Winston,2016,7110,6608,502
West Virginia,Wirt,2016,2230,2034,196
Texas,Wise,2016,29413,28025,1388
Virginia,Wise,2016,13192,12063,1129
Kentucky,Wolfe,2016,1919,1723,196
Ohio,Wood,2016,70624,67655,2969
Texas,Wood,2016,17234,16328,906
Wisconsin,Wood,2016,34671,33038,1633
West Virginia,Wood,2016,36806,34691,2115
Iowa,Woodbury,2016,55604,53622,1982
Illinois,Woodford,2016,19351,18289,1062
Kentucky,Woodford,2016,14753,14276,477
Arkansas,Woodruff,2016,2964,2802,162
Oklahoma,Woods,2016,5224,5056,168
Kansas,Woodson,2016,1616,1523,93
Oklahoma,Woodward,2016,9526,8936,590
Massachusetts,Worcester,2016,430028,412400,17628
Maryland,Worcester,2016,25291,22935,2356
Georgia,Worth,2016,9108,8577,531
Iowa,Worth,2016,4258,4112,146
Missouri,Worth,2016,1213,1177,36
Alaska,Wrangell Borough/city,2016,1053,974,79
Iowa,Wright,2016,6674,6399,275
Minnesota,Wright,2016,73353,70529,2824
Missouri,Wright,2016,7616,7165,451
Ohio,Wyandot,2016,12669,12196,473
Kansas,Wyandotte,2016,76353,72109,4244
New York,Wyoming,2016,18102,17137,965
Pennsylvania,Wyoming,2016,14082,13209,873
West Virginia,Wyoming,2016,7417,6660,757
Virginia,Wythe,2016,13642,12856,786
Puerto Rico,Yabucoa Municipio,2016,9081,7545,1536
North Carolina,Yadkin,2016,17612,16841,771
Washington,Yakima,2016,125655,116117,9538
Alaska,Yakutat Borough/city,2016,243,223,20
Mississippi,Yalobusha,2016,4889,4584,305
Oregon,Yamhill,2016,53176,50733,2443
North Carolina,Yancey,2016,7478,7093,385
South Dakota,Yankton,2016,11583,11286,297
New York,Yates,2016,11713,11196,517
Puerto Rico,Yauco Municipio,2016,10735,8719,2016
Arizona,Yavapai,2016,99398,94517,4881
Mississippi,Yazoo,2016,9252,8572,680
Arkansas,Yell,2016,8672,8285,387
Minnesota,Yellow Medicine,2016,5497,5287,210
Montana,Yellowstone,2016,81264,78343,2921
Texas,Yoakum,2016,3758,3579,179
California,Yolo,2016,106058,99812,6246
Maine,York,2016,110962,107223,3739
Nebraska,York,2016,7314,7117,197
Pennsylvania,York,2016,234807,223986,10821
South Carolina,York,2016,130876,124812,6064
Virginia,York,2016,32068,30810,1258
Texas,Young,2016,8304,7941,363
California,Yuba,2016,28144,25722,2422
Alaska,Yukon-Koyukuk Census Area,2016,2419,1987,432
Arizona,Yuma,2016,93912,76271,17641
Colorado,Yuma,2016,5434,5318,116
Texas,Zapata,2016,5204,4645,559
Texas,Zavala,2016,3883,3345,538
South Dakota,Ziebach,2016,976,932,44
