State,County,Year,LabourForce,Employed,Unemployed
Alabama,Autauga,2019,26172,25458,714
Alabama,Baldwin,2019,97328,94675,2653
Alabama,Barbour,2019,8537,8213,324
Alabama,Bibb,2019,8685,8419,266
Alabama,Blount,2019,25331,24655,676
Alabama,Bullock,2019,4818,4643,175
Alabama,Butler,2019,9263,8925,338
Alabama,Calhoun,2019,46209,44574,1635
Alabama,Chambers,2019,15748,15286,462
Alabama,Cherokee,2019,11604,11266,338
Alabama,Chilton,2019,19818,19280,538
Alabama,Choctaw,2019,4670,4452,218
Alabama,Clarke,2019,7557,7121,436
Alabama,Clay,2019,6101,5918,183
Alabama,Cleburne,2019,5806,5623,183
Alabama,Coffee,2019,21402,20779,623
Alabama,Colbert,2019,23646,22761,885
Alabama,Conecuh,2019,4533,4353,180
Alabama,Coosa,2019,4549,4414,135
Alabama,Covington,2019,15653,15119,534
Alabama,Crenshaw,2019,6476,6293,183
Alabama,Cullman,2019,38646,37648,998
Alabama,Dale,2019,20724,20082,642
Alabama,Dallas,2019,14711,13904,807
Alabama,DeKalb,2019,31052,30182,870
Alabama,Elmore,2019,37565,36586,979
Alabama,Escambia,2019,14762,14248,514
Alabama,Etowah,2019,42723,41295,1428
Alabama,Fayette,2019,6579,6372,207
Alabama,Franklin,2019,14696,14291,405
Alabama,Geneva,2019,11045,10725,320
Alabama,Greene,2019,2883,2722,161
Alabama,Hale,2019,6119,5878,241
Alabama,Henry,2019,6944,6697,247
Alabama,Houston,2019,46234,44844,1390
Alabama,Jackson,2019,23484,22712,772
Alabama,Jefferson,2019,318755,309664,9091
Alabama,Lamar,2019,5849,5670,179
Alabama,Lauderdale,2019,42548,41160,1388
Alabama,Lawrence,2019,14306,13859,447
Alabama,Lee,2019,76580,74500,2080
Alabama,Limestone,2019,43854,42700,1154
Alabama,Lowndes,2019,3587,3383,204
Alabama,Macon,2019,7850,7513,337
Alabama,Madison,2019,185219,180505,4714
Alabama,Marengo,2019,7694,7423,271
Alabama,Marion,2019,12932,12486,446
Alabama,Marshall,2019,44085,42999,1086
Alabama,Mobile,2019,189107,182083,7024
Alabama,Monroe,2019,7329,6973,356
Alabama,Montgomery,2019,105777,102517,3260
Alabama,Morgan,2019,58271,56771,1500
Alabama,Perry,2019,3413,3235,178
Alabama,Pickens,2019,7923,7647,276
Alabama,Pike,2019,15428,14924,504
Alabama,Randolph,2019,9639,9347,292
Alabama,Russell,2019,23896,23198,698
Alabama,Shelby,2019,115939,113414,2525
Alabama,St. Clair,2019,40532,39441,1091
Alabama,Sumter,2019,4854,4635,219
Alabama,Talladega,2019,35769,34556,1213
Alabama,Tallapoosa,2019,18652,18096,556
Alabama,Tuscaloosa,2019,104964,102122,2842
Alabama,Walker,2019,25347,24517,830
Alabama,Washington,2019,6800,6487,313
Alabama,Wilcox,2019,2739,2544,195
Alabama,Winston,2019,10041,9705,336
Alaska,Aleutians East Borough,2019,2428,2360,68
Alaska,Aleutians West Census Area,2019,3606,3477,129
Alaska,Anchorage Borough/municipality,2019,146949,139526,7423
Alaska,Bethel Census Area,2019,7025,6120,905
Alaska,Bristol Bay Borough,2019,441,414,27
Alaska,Denali Borough,2019,1038,950,88
Alaska,Dillingham Census Area,2019,1938,1781,157
Alaska,Fairbanks North Star Borough,2019,44652,42248,2404
Alaska,Haines Borough,2019,1111,1012,99
Alaska,Hoonah-Angoon Census Area,2019,1160,1028,132
Alaska,Juneau Borough/city,2019,16999,16243,756
Alaska,Kenai Peninsula Borough,2019,26161,24383,1778
Alaska,Ketchikan Gateway Borough,2019,6884,6456,428
Alaska,Kodiak Island Borough,2019,5912,5582,330
Alaska,Kusilvak Census Area,2019,2682,2164,518
Alaska,Lake and Peninsula Borough,2019,708,638,70
Alaska,Matanuska-Susitna Borough,2019,46901,43661,3240
Alaska,Nome Census Area,2019,4036,3596,440
Alaska,North Slope Borough,2019,3485,3261,224
Alaska,Northwest Arctic Borough,2019,2934,2523,411
Alaska,Petersburg Borough,2019,1388,1267,121
Alaska,Prince of Wales-Hyder Census Area,2019,2851,2562,289
Alaska,Sitka Borough/city,2019,4336,4155,181
Alaska,Skagway Municipality,2019,822,746,76
Alaska,Southeast Fairbanks Census Area,2019,2810,2558,252
Alaska,Valdez-Cordova Census Area,2019,4815,4452,363
Alaska,Wrangell Borough/city,2019,1002,925,77
Alaska,Yakutat Borough/city,2019,246,227,19
Alaska,Yukon-Koyukuk Census Area,2019,2458,2113,345
Arizona,Apache,2019,20487,18468,2019
Arizona,Cochise,2019,50594,47695,2899
Arizona,Coconino,2019,77507,73206,4301
Arizona,Gila,2019,21677,20485,1192
Arizona,Graham,2019,15351,14608,743
Arizona,Greenlee,2019,4520,4342,178
Arizona,La Paz,2019,9334,8789,545
Arizona,Maricopa,2019,2310503,2217656,92847
Arizona,Mohave,2019,87792,82815,4977
Arizona,Navajo,2019,40979,37973,3006
Arizona,Pima,2019,498695,476620,22075
Arizona,Pinal,2019,187480,178309,9171
Arizona,Santa Cruz,2019,19636,17963,1673
Arizona,Yavapai,2019,106880,102138,4742
Arizona,Yuma,2019,99824,83437,16387
Arkansas,Arkansas,2019,9427,9141,286
Arkansas,Ashley,2019,7751,7333,418
Arkansas,Baxter,2019,16296,15646,650
Arkansas,Benton,2019,137211,133610,3601
Arkansas,Boone,2019,16036,15525,511
Arkansas,Bradley,2019,4483,4298,185
Arkansas,Calhoun,2019,2453,2345,108
Arkansas,Carroll,2019,12783,12383,400
Arkansas,Chicot,2019,3285,3057,228
Arkansas,Clark,2019,9691,9323,368
Arkansas,Clay,2019,5691,5413,278
Arkansas,Cleburne,2019,9226,8808,418
Arkansas,Cleveland,2019,3219,3092,127
Arkansas,Columbia,2019,9140,8730,410
Arkansas,Conway,2019,8285,7926,359
Arkansas,Craighead,2019,55652,54097,1555
Arkansas,Crawford,2019,26922,26028,894
Arkansas,Crittenden,2019,21422,20512,910
Arkansas,Cross,2019,7411,7097,314
Arkansas,Dallas,2019,2840,2706,134
Arkansas,Desha,2019,5402,5161,241
Arkansas,Drew,2019,7864,7456,408
Arkansas,Faulkner,2019,62431,60556,1875
Arkansas,Franklin,2019,7494,7242,252
Arkansas,Fulton,2019,4962,4763,199
Arkansas,Garland,2019,41346,39809,1537
Arkansas,Grant,2019,8403,8136,267
Arkansas,Greene,2019,20065,19366,699
Arkansas,Hempstead,2019,9951,9571,380
Arkansas,Hot Spring,2019,14019,13509,510
Arkansas,Howard,2019,5711,5525,186
Arkansas,Independence,2019,16527,15868,659
Arkansas,Izard,2019,4912,4643,269
Arkansas,Jackson,2019,5840,5460,380
Arkansas,Jefferson,2019,27740,26220,1520
Arkansas,Johnson,2019,10278,9809,469
Arkansas,Lafayette,2019,2466,2351,115
Arkansas,Lawrence,2019,6817,6533,284
Arkansas,Lee,2019,2833,2706,127
Arkansas,Lincoln,2019,3950,3777,173
Arkansas,Little River,2019,5518,5280,238
Arkansas,Logan,2019,8583,8210,373
Arkansas,Lonoke,2019,34468,33359,1109
Arkansas,Madison,2019,7427,7238,189
Arkansas,Marion,2019,6673,6406,267
Arkansas,Miller,2019,19750,18941,809
Arkansas,Mississippi,2019,17358,16467,891
Arkansas,Monroe,2019,2761,2642,119
Arkansas,Montgomery,2019,2970,2832,138
Arkansas,Nevada,2019,3662,3517,145
Arkansas,Newton,2019,3335,3218,117
Arkansas,Ouachita,2019,9838,9330,508
Arkansas,Perry,2019,4275,4100,175
Arkansas,Phillips,2019,6379,5996,383
Arkansas,Pike,2019,4250,4086,164
Arkansas,Poinsett,2019,10279,9929,350
Arkansas,Polk,2019,8121,7782,339
Arkansas,Pope,2019,28869,27618,1251
Arkansas,Prairie,2019,3586,3430,156
Arkansas,Pulaski,2019,190248,183776,6472
Arkansas,Randolph,2019,7301,7017,284
Arkansas,Saline,2019,59114,57450,1664
Arkansas,Scott,2019,4314,4167,147
Arkansas,Searcy,2019,2914,2781,133
Arkansas,Sebastian,2019,56698,54834,1864
Arkansas,Sevier,2019,5513,5248,265
Arkansas,Sharp,2019,5742,5457,285
Arkansas,St. Francis,2019,8197,7772,425
Arkansas,Stone,2019,4726,4503,223
Arkansas,Union,2019,15847,15018,829
Arkansas,Van Buren,2019,5741,5455,286
Arkansas,Washington,2019,124967,121914,3053
Arkansas,White,2019,33800,32281,1519
Arkansas,Woodruff,2019,2773,2627,146
Arkansas,Yell,2019,8417,8081,336
California,Alameda,2019,844346,819675,24671
California,Alpine,2019,551,523,28
California,Amador,2019,14900,14328,572
California,Butte,2019,99242,94162,5080
California,Calaveras,2019,21428,20616,812
California,Colusa,2019,10993,9586,1407
California,Contra Costa,2019,561757,544496,17261
California,Del Norte,2019,9674,9119,555
California,El Dorado,2019,92022,88785,3237
California,Fresno,2019,450760,418092,32668
California,Glenn,2019,12997,12201,796
California,Humboldt,2019,62507,60254,2253
California,Imperial,2019,71411,58331,13080
California,Inyo,2019,8760,8450,310
California,Kern,2019,390999,360783,30216
California,Kings,2019,57788,53222,4566
California,Lake,2019,29158,27687,1471
California,Lassen,2019,9869,9416,453
California,Los Angeles,2019,5121584,4894296,227288
California,Madera,2019,61945,57651,4294
California,Marin,2019,139979,136786,3193
California,Mariposa,2019,7612,7262,350
California,Mendocino,2019,38934,37388,1546
California,Merced,2019,116226,106866,9360
California,Modoc,2019,3171,2947,224
California,Mono,2019,8508,8195,313
California,Monterey,2019,222516,208717,13799
California,Napa,2019,74004,71900,2104
California,Nevada,2019,48639,47022,1617
California,Orange,2019,1623421,1578334,45087
California,Placer,2019,187932,182093,5839
California,Plumas,2019,7903,7296,607
California,Riverside,2019,1104035,1057884,46151
California,Sacramento,2019,712394,686298,26096
California,San Benito,2019,31432,29845,1587
California,San Bernardino,2019,967719,930709,37010
California,San Diego,2019,1590591,1539948,50643
California,San Francisco,2019,583186,570412,12774
California,San Joaquin,2019,327077,307854,19223
California,San Luis Obispo,2019,140931,136914,4017
California,San Mateo,2019,460044,450647,9397
California,Santa Barbara,2019,217882,209843,8039
California,Santa Clara,2019,1053723,1027527,26196
California,Santa Cruz,2019,142277,135530,6747
California,Shasta,2019,74353,70878,3475
California,Sierra,2019,1326,1255,71
California,Siskiyou,2019,17227,16109,1118
California,Solano,2019,209527,201672,7855
California,Sonoma,2019,259394,252428,6966
California,Stanislaus,2019,243454,228753,14701
California,Sutter,2019,45785,42440,3345
California,Tehama,2019,25650,24228,1422
California,Trinity,2019,4693,4436,257
California,Tulare,2019,203980,184353,19627
California,Tuolumne,2019,21317,20366,951
California,Ventura,2019,423390,408169,15221
California,Yolo,2019,108658,104220,4438
California,Yuba,2019,29997,28182,1815
Colorado,Adams,2019,275440,267375,8065
Colorado,Alamosa,2019,8726,8413,313
Colorado,Arapahoe,2019,368504,358574,9930
Colorado,Archuleta,2019,6937,6717,220
Colorado,Baca,2019,2175,2138,37
Colorado,Bent,2019,1919,1863,56
Colorado,Boulder,2019,196991,192351,4640
Colorado,Broomfield,2019,40520,39528,992
Colorado,Chaffee,2019,9871,9636,235
Colorado,Cheyenne,2019,1173,1154,19
Colorado,Clear Creek,2019,6110,5960,150
Colorado,Conejos,2019,4165,4013,152
Colorado,Costilla,2019,1888,1814,74
Colorado,Crowley,2019,1525,1460,65
Colorado,Custer,2019,2088,2025,63
Colorado,Delta,2019,14519,14035,484
Colorado,Denver,2019,421322,409974,11348
Colorado,Dolores,2019,1164,1129,35
Colorado,Douglas,2019,196248,191586,4662
Colorado,Eagle,2019,37073,36241,832
Colorado,El Paso,2019,342735,331453,11282
Colorado,Elbert,2019,15344,15009,335
Colorado,Fremont,2019,15251,14548,703
Colorado,Garfield,2019,32910,32021,889
Colorado,Gilpin,2019,3820,3732,88
Colorado,Grand,2019,9978,9765,213
Colorado,Gunnison,2019,11594,11346,248
Colorado,Hinsdale,2019,438,422,16
Colorado,Huerfano,2019,2542,2396,146
Colorado,Jackson,2019,1003,980,23
Colorado,Jefferson,2019,338722,330124,8598
Colorado,Kiowa,2019,965,950,15
Colorado,Kit Carson,2019,4365,4292,73
Colorado,La Plata,2019,32305,31495,810
Colorado,Lake,2019,4994,4878,116
Colorado,Larimer,2019,206483,201624,4859
Colorado,Las Animas,2019,6635,6377,258
Colorado,Lincoln,2019,2431,2375,56
Colorado,Logan,2019,11167,10904,263
Colorado,Mesa,2019,76614,73986,2628
Colorado,Mineral,2019,533,521,12
Colorado,Moffat,2019,7450,7195,255
Colorado,Montezuma,2019,13038,12486,552
Colorado,Montrose,2019,22010,21327,683
Colorado,Morgan,2019,16582,16146,436
Colorado,Otero,2019,8495,8150,345
Colorado,Ouray,2019,2454,2383,71
Colorado,Park,2019,11292,11010,282
Colorado,Phillips,2019,2631,2589,42
Colorado,Pitkin,2019,11395,11041,354
Colorado,Prowers,2019,6408,6240,168
Colorado,Pueblo,2019,76276,73147,3129
Colorado,Rio Blanco,2019,3019,2908,111
Colorado,Rio Grande,2019,5506,5280,226
Colorado,Routt,2019,16491,16132,359
Colorado,Saguache,2019,3606,3462,144
Colorado,San Juan,2019,570,553,17
Colorado,San Miguel,2019,5900,5737,163
Colorado,Sedgwick,2019,1231,1206,25
Colorado,Summit,2019,23179,22760,419
Colorado,Teller,2019,12821,12425,396
Colorado,Washington,2019,3000,2941,59
Colorado,Weld,2019,170001,165670,4331
Colorado,Yuma,2019,6224,6126,98
Connecticut,Fairfield,2019,481023,463547,17476
Connecticut,Hartford,2019,483303,464533,18770
Connecticut,Litchfield,2019,105182,101543,3639
Connecticut,Middlesex,2019,93696,90703,2993
Connecticut,New Haven,2019,461613,443514,18099
Connecticut,New London,2019,137386,132423,4963
Connecticut,Tolland,2019,87047,84207,2840
Connecticut,Windham,2019,64281,61697,2584
Delaware,Kent,2019,79411,76097,3314
Delaware,New Castle,2019,300148,289100,11048
Delaware,Sussex,2019,107706,103648,4058
Florida,Alachua,2019,139217,135112,4105
Florida,Baker,2019,11852,11484,368
Florida,Bay,2019,84235,80980,3255
Florida,Bradford,2019,11062,10715,347
Florida,Brevard,2019,284087,275025,9062
Florida,Broward,2019,1040519,1008813,31706
Florida,Calhoun,2019,4819,4622,197
Florida,Charlotte,2019,71865,69239,2626
Florida,Citrus,2019,47377,45096,2281
Florida,Clay,2019,107718,104467,3251
Florida,Collier,2019,180626,175040,5586
Florida,Columbia,2019,29797,28831,966
Florida,DeSoto,2019,14185,13686,499
Florida,Dixie,2019,5828,5606,222
Florida,Duval,2019,491946,475890,16056
Florida,Escambia,2019,145919,141253,4666
Florida,Flagler,2019,47030,45235,1795
Florida,Franklin,2019,4650,4486,164
Florida,Gadsden,2019,18833,18061,772
Florida,Gilchrist,2019,7145,6900,245
Florida,Glades,2019,5384,5173,211
Florida,Gulf,2019,5772,5495,277
Florida,Hamilton,2019,4340,4162,178
Florida,Hardee,2019,8502,8074,428
Florida,Hendry,2019,15587,14680,907
Florida,Hernando,2019,71923,68906,3017
Florida,Highlands,2019,36094,34452,1642
Florida,Hillsborough,2019,750269,727117,23152
Florida,Holmes,2019,6947,6701,246
Florida,Indian River,2019,65457,62949,2508
Florida,Jackson,2019,17145,16522,623
Florida,Jefferson,2019,5623,5436,187
Florida,Lafayette,2019,2855,2769,86
Florida,Lake,2019,159027,153919,5108
Florida,Lee,2019,348027,337116,10911
Florida,Leon,2019,155493,150713,4780
Florida,Levy,2019,16725,16104,621
Florida,Liberty,2019,2639,2545,94
Florida,Madison,2019,7469,7188,281
Florida,Manatee,2019,179993,174382,5611
Florida,Marion,2019,137624,132335,5289
Florida,Martin,2019,74119,71786,2333
Florida,Miami-Dade,2019,1383989,1350924,33065
Florida,Monroe,2019,46755,45792,963
Florida,Nassau,2019,41210,40000,1210
Florida,Okaloosa,2019,96940,94342,2598
Florida,Okeechobee,2019,17801,17184,617
Florida,Orange,2019,762737,740564,22173
Florida,Osceola,2019,184329,178283,6046
Florida,Palm Beach,2019,733663,709694,23969
Florida,Pasco,2019,237941,229631,8310
Florida,Pinellas,2019,494185,479472,14713
Florida,Polk,2019,305752,294472,11280
Florida,Putnam,2019,26563,25413,1150
Florida,Santa Rosa,2019,82903,80448,2455
Florida,Sarasota,2019,189137,183288,5849
Florida,Seminole,2019,255529,248085,7444
Florida,St. Johns,2019,132464,128970,3494
Florida,St. Lucie,2019,145111,139389,5722
Florida,Sumter,2019,32628,31126,1502
Florida,Suwannee,2019,18046,17427,619
Florida,Taylor,2019,8229,7934,295
Florida,Union,2019,4638,4501,137
Florida,Volusia,2019,254312,245545,8767
Florida,Wakulla,2019,14921,14487,434
Florida,Walton,2019,31577,30685,892
Florida,Washington,2019,9678,9348,330
Georgia,Appling,2019,9306,8945,361
Georgia,Atkinson,2019,4695,4552,143
Georgia,Bacon,2019,4966,4790,176
Georgia,Baker,2019,1163,1108,55
Georgia,Baldwin,2019,17409,16671,738
Georgia,Banks,2019,9616,9352,264
Georgia,Barrow,2019,40385,39247,1138
Georgia,Bartow,2019,50539,48885,1654
Georgia,Ben Hill,2019,5348,5053,295
Georgia,Berrien,2019,7474,7176,298
Georgia,Bibb,2019,67896,65249,2647
Georgia,Bleckley,2019,4531,4303,228
Georgia,Brantley,2019,7258,6964,294
Georgia,Brooks,2019,6901,6668,233
Georgia,Bryan,2019,18286,17738,548
Georgia,Bulloch,2019,36540,35170,1370
Georgia,Burke,2019,9154,8689,465
Georgia,Butts,2019,10737,10377,360
Georgia,Calhoun,2019,2233,2152,81
Georgia,Camden,2019,20869,20113,756
Georgia,Candler,2019,5548,5383,165
Georgia,Carroll,2019,55210,53325,1885
Georgia,Catoosa,2019,33517,32518,999
Georgia,Charlton,2019,4785,4604,181
Georgia,Chatham,2019,139657,135052,4605
Georgia,Chattahoochee,2019,1997,1906,91
Georgia,Chattooga,2019,10307,9795,512
Georgia,Cherokee,2019,135814,132118,3696
Georgia,Clarke,2019,59096,56997,2099
Georgia,Clay,2019,880,819,61
Georgia,Clayton,2019,137796,131980,5816
Georgia,Clinch,2019,2654,2550,104
Georgia,Cobb,2019,425167,412592,12575
Georgia,Coffee,2019,18869,18138,731
Georgia,Colquitt,2019,21377,20702,675
Georgia,Columbia,2019,75134,72860,2274
Georgia,Cook,2019,7988,7718,270
Georgia,Coweta,2019,74594,72410,2184
Georgia,Crawford,2019,5605,5404,201
Georgia,Crisp,2019,9433,9065,368
Georgia,Dade,2019,8209,7941,268
Georgia,Dawson,2019,12320,11971,349
Georgia,Decatur,2019,11540,11101,439
Georgia,DeKalb,2019,399354,385700,13654
Georgia,Dodge,2019,7081,6700,381
Georgia,Dooly,2019,5071,4880,191
Georgia,Dougherty,2019,38327,36509,1818
Georgia,Douglas,2019,73217,70640,2577
Georgia,Early,2019,4372,4201,171
Georgia,Echols,2019,1909,1856,53
Georgia,Effingham,2019,30889,30000,889
Georgia,Elbert,2019,7658,7352,306
Georgia,Emanuel,2019,8287,7847,440
Georgia,Evans,2019,4862,4698,164
Georgia,Fannin,2019,11512,11132,380
Georgia,Fayette,2019,57985,56256,1729
Georgia,Floyd,2019,44144,42455,1689
Georgia,Forsyth,2019,122076,118737,3339
Georgia,Franklin,2019,9942,9592,350
Georgia,Fulton,2019,556954,537605,19349
Georgia,Gilmer,2019,11861,11444,417
Georgia,Glascock,2019,1272,1225,47
Georgia,Glynn,2019,39345,38039,1306
Georgia,Gordon,2019,27976,27025,951
Georgia,Grady,2019,10449,10093,356
Georgia,Greene,2019,7010,6740,270
Georgia,Gwinnett,2019,489610,474882,14728
Georgia,Habersham,2019,19069,18411,658
Georgia,Hall,2019,102061,99222,2839
Georgia,Hancock,2019,2447,2312,135
Georgia,Haralson,2019,12557,12141,416
Georgia,Harris,2019,16649,16139,510
Georgia,Hart,2019,11303,10903,400
Georgia,Heard,2019,5248,5073,175
Georgia,Henry,2019,115495,111409,4086
Georgia,Houston,2019,70345,68005,2340
Georgia,Irwin,2019,3328,3172,156
Georgia,Jackson,2019,36518,35550,968
Georgia,Jasper,2019,6939,6726,213
Georgia,Jeff Davis,2019,6051,5772,279
Georgia,Jefferson,2019,6572,6260,312
Georgia,Jenkins,2019,3143,2983,160
Georgia,Johnson,2019,4036,3889,147
Georgia,Jones,2019,13696,13262,434
Georgia,Lamar,2019,8232,7914,318
Georgia,Lanier,2019,3748,3601,147
Georgia,Laurens,2019,19142,18269,873
Georgia,Lee,2019,14717,14268,449
Georgia,Liberty,2019,26096,25119,977
Georgia,Lincoln,2019,3554,3417,137
Georgia,Long,2019,8137,7841,296
Georgia,Lowndes,2019,51180,49376,1804
Georgia,Lumpkin,2019,16719,16200,519
Georgia,Macon,2019,4693,4476,217
Georgia,Madison,2019,13282,12877,405
Georgia,Marion,2019,3305,3165,140
Georgia,McDuffie,2019,8852,8402,450
Georgia,McIntosh,2019,6167,5948,219
Georgia,Meriwether,2019,8911,8510,401
Georgia,Miller,2019,2749,2659,90
Georgia,Mitchell,2019,8445,8060,385
Georgia,Monroe,2019,12995,12574,421
Georgia,Montgomery,2019,3807,3607,200
Georgia,Morgan,2019,9240,8953,287
Georgia,Murray,2019,15505,14725,780
Georgia,Muscogee,2019,77490,73977,3513
Georgia,Newton,2019,52197,50187,2010
Georgia,Oconee,2019,19510,19014,496
Georgia,Oglethorpe,2019,6929,6706,223
Georgia,Paulding,2019,85916,83397,2519
Georgia,Peach,2019,11826,11343,483
Georgia,Pickens,2019,15271,14816,455
Georgia,Pierce,2019,8698,8404,294
Georgia,Pike,2019,8899,8631,268
Georgia,Polk,2019,18429,17761,668
Georgia,Pulaski,2019,4052,3896,156
Georgia,Putnam,2019,8185,7831,354
Georgia,Quitman,2019,800,760,40
Georgia,Rabun,2019,7152,6900,252
Georgia,Randolph,2019,2527,2405,122
Georgia,Richmond,2019,85085,81242,3843
Georgia,Rockdale,2019,44751,43061,1690
Georgia,Schley,2019,2200,2115,85
Georgia,Screven,2019,5088,4813,275
Georgia,Seminole,2019,3037,2903,134
Georgia,Spalding,2019,28675,27530,1145
Georgia,Stephens,2019,10685,10273,412
Georgia,Stewart,2019,2396,2296,100
Georgia,Sumter,2019,12686,12077,609
Georgia,Talbot,2019,2819,2693,126
Georgia,Taliaferro,2019,567,539,28
Georgia,Tattnall,2019,9560,9194,366
Georgia,Taylor,2019,3074,2950,124
Georgia,Telfair,2019,4107,3716,391
Georgia,Terrell,2019,3510,3333,177
Georgia,Thomas,2019,16470,15807,663
Georgia,Tift,2019,19751,19088,663
Georgia,Toombs,2019,11655,11079,576
Georgia,Towns,2019,3893,3705,188
Georgia,Treutlen,2019,2642,2503,139
Georgia,Troup,2019,37304,36117,1187
Georgia,Turner,2019,3139,3019,120
Georgia,Twiggs,2019,2878,2722,156
Georgia,Union,2019,10274,9953,321
Georgia,Upson,2019,11320,10916,404
Georgia,Walker,2019,31358,30242,1116
Georgia,Walton,2019,46011,44601,1410
Georgia,Ware,2019,15555,14986,569
Georgia,Warren,2019,2821,2693,128
Georgia,Washington,2019,7013,6722,291
Georgia,Wayne,2019,11403,10947,456
Georgia,Webster,2019,1007,957,50
Georgia,Wheeler,2019,1610,1490,120
Georgia,White,2019,16266,15836,430
Georgia,Whitfield,2019,43564,41637,1927
Georgia,Wilcox,2019,2695,2575,120
Georgia,Wilkes,2019,3823,3650,173
Georgia,Wilkinson,2019,3959,3808,151
Georgia,Worth,2019,8897,8552,345
Hawaii,Hawaii,2019,91161,88018,3143
Hawaii,Honolulu,2019,450562,438936,11626
Hawaii,Kauai,2019,36536,35558,978
Hawaii,Maui,2019,86733,84461,2272
Idaho,Ada,2019,254224,247855,6369
Idaho,Adams,2019,1721,1604,117
Idaho,Bannock,2019,42752,41546,1206
Idaho,Benewah,2019,4109,3894,215
Idaho,Bingham,2019,23817,23182,635
Idaho,Blaine,2019,12318,11995,323
Idaho,Boise,2019,3516,3365,151
Idaho,Bonner,2019,20058,19222,836
Idaho,Bonneville,2019,57042,55678,1364
Idaho,Boundary,2019,5376,5138,238
Idaho,Butte,2019,1397,1360,37
Idaho,Camas,2019,695,676,19
Idaho,Canyon,2019,104402,101058,3344
Idaho,Caribou,2019,4135,4025,110
Idaho,Cassia,2019,12215,11920,295
Idaho,Clark,2019,378,364,14
Idaho,Clearwater,2019,2905,2708,197
Idaho,Custer,2019,2228,2134,94
Idaho,Elmore,2019,11547,11169,378
Idaho,Franklin,2019,7041,6876,165
Idaho,Fremont,2019,7870,7686,184
Idaho,Gem,2019,8308,8035,273
Idaho,Gooding,2019,8222,8005,217
Idaho,Idaho,2019,6563,6265,298
Idaho,Jefferson,2019,14035,13709,326
Idaho,Jerome,2019,12199,11884,315
Idaho,Kootenai,2019,80102,77257,2845
Idaho,Latah,2019,20549,19994,555
Idaho,Lemhi,2019,3566,3396,170
Idaho,Lewis,2019,1648,1558,90
Idaho,Lincoln,2019,2703,2607,96
Idaho,Madison,2019,21941,21539,402
Idaho,Minidoka,2019,11442,11151,291
Idaho,Nez Perce,2019,21057,20459,598
Idaho,Oneida,2019,2321,2268,53
Idaho,Owyhee,2019,5434,5251,183
Idaho,Payette,2019,11663,11248,415
Idaho,Power,2019,4092,3965,127
Idaho,Shoshone,2019,5143,4839,304
Idaho,Teton,2019,6626,6480,146
Idaho,Twin Falls,2019,41393,40234,1159
Idaho,Valley,2019,5554,5338,216
Idaho,Washington,2019,4612,4420,192
Illinois,Adams,2019,32358,31249,1109
Illinois,Alexander,2019,2050,1923,127
Illinois,Bond,2019,7833,7533,300
Illinois,Boone,2019,26377,24890,1487
Illinois,Brown,2019,2993,2921,72
Illinois,Bureau,2019,17392,16585,807
Illinois,Calhoun,2019,2338,2225,113
Illinois,Carroll,2019,7325,7022,303
Illinois,Cass,2019,6131,5878,253
Illinois,Champaign,2019,109116,105014,4102
Illinois,Christian,2019,14615,13910,705
Illinois,Clark,2019,7693,7345,348
Illinois,Clay,2019,6508,6212,296
Illinois,Clinton,2019,20548,19908,640
Illinois,Coles,2019,23855,22889,966
Illinois,Cook,2019,2594759,2496526,98233
Illinois,Crawford,2019,8715,8340,375
Illinois,Cumberland,2019,6125,5915,210
Illinois,De Witt,2019,7490,7165,325
Illinois,DeKalb,2019,55397,53115,2282
Illinois,Douglas,2019,10263,9897,366
Illinois,DuPage,2019,507802,492985,14817
Illinois,Edgar,2019,9019,8636,383
Illinois,Edwards,2019,2715,2604,111
Illinois,Effingham,2019,19370,18740,630
Illinois,Fayette,2019,9940,9504,436
Illinois,Ford,2019,6490,6211,279
Illinois,Franklin,2019,16456,15565,891
Illinois,Fulton,2019,15262,14409,853
Illinois,Gallatin,2019,2359,2244,115
Illinois,Greene,2019,6036,5776,260
Illinois,Grundy,2019,25443,24307,1136
Illinois,Hamilton,2019,4449,4277,172
Illinois,Hancock,2019,8464,8067,397
Illinois,Hardin,2019,1318,1231,87
Illinois,Henderson,2019,3638,3463,175
Illinois,Henry,2019,25217,24015,1202
Illinois,Iroquois,2019,14481,13873,608
Illinois,Jackson,2019,28083,27012,1071
Illinois,Jasper,2019,4667,4469,198
Illinois,Jefferson,2019,17525,16720,805
Illinois,Jersey,2019,11044,10555,489
Illinois,Jo Daviess,2019,10869,10428,441
Illinois,Johnson,2019,4155,3905,250
Illinois,Kane,2019,274298,262136,12162
Illinois,Kankakee,2019,56207,53396,2811
Illinois,Kendall,2019,68630,66358,2272
Illinois,Knox,2019,21856,20771,1085
Illinois,Lake,2019,378425,362822,15603
Illinois,LaSalle,2019,55002,52081,2921
Illinois,Lawrence,2019,5913,5606,307
Illinois,Lee,2019,17724,17018,706
Illinois,Livingston,2019,16663,15984,679
Illinois,Logan,2019,12739,12185,554
Illinois,Macon,2019,48905,46328,2577
Illinois,Macoupin,2019,23125,22136,989
Illinois,Madison,2019,134999,129708,5291
Illinois,Marion,2019,17680,16889,791
Illinois,Marshall,2019,5366,5108,258
Illinois,Mason,2019,6342,6004,338
Illinois,Massac,2019,5652,5336,316
Illinois,McDonough,2019,13458,12830,628
Illinois,McHenry,2019,165574,160086,5488
Illinois,McLean,2019,88460,85134,3326
Illinois,Menard,2019,6542,6295,247
Illinois,Mercer,2019,8168,7761,407
Illinois,Monroe,2019,18902,18313,589
Illinois,Montgomery,2019,11823,11207,616
Illinois,Morgan,2019,16578,15910,668
Illinois,Moultrie,2019,7638,7384,254
Illinois,Ogle,2019,25162,23947,1215
Illinois,Peoria,2019,85453,81085,4368
Illinois,Perry,2019,8391,7960,431
Illinois,Piatt,2019,8632,8319,313
Illinois,Pike,2019,7057,6751,306
Illinois,Pope,2019,1693,1599,94
Illinois,Pulaski,2019,1996,1865,131
Illinois,Putnam,2019,3066,2912,154
Illinois,Randolph,2019,14371,13842,529
Illinois,Richland,2019,7273,6975,298
Illinois,Rock Island,2019,71937,68377,3560
Illinois,Saline,2019,9702,9188,514
Illinois,Sangamon,2019,101644,97552,4092
Illinois,Schuyler,2019,3277,3139,138
Illinois,Scott,2019,2530,2410,120
Illinois,Shelby,2019,10695,10278,417
Illinois,St. Clair,2019,127362,121685,5677
Illinois,Stark,2019,2555,2409,146
Illinois,Stephenson,2019,21823,20868,955
Illinois,Tazewell,2019,64182,61347,2835
Illinois,Union,2019,7494,7070,424
Illinois,Vermilion,2019,33251,31540,1711
Illinois,Wabash,2019,5874,5648,226
Illinois,Warren,2019,8556,8207,349
Illinois,Washington,2019,10254,9995,259
Illinois,Wayne,2019,7031,6696,335
Illinois,White,2019,6663,6409,254
Illinois,Whiteside,2019,28849,27619,1230
Illinois,Will,2019,357236,343602,13634
Illinois,Williamson,2019,32146,30765,1381
Illinois,Winnebago,2019,140238,132290,7948
Illinois,Woodford,2019,18870,18165,705
Indiana,Adams,2019,17255,16785,470
Indiana,Allen,2019,186799,180923,5876
Indiana,Bartholomew,2019,45027,43902,1125
Indiana,Benton,2019,4582,4436,146
Indiana,Blackford,2019,5006,4808,198
Indiana,Boone,2019,36450,35553,897
Indiana,Brown,2019,7750,7518,232
Indiana,Carroll,2019,10276,9967,309
Indiana,Cass,2019,17995,17366,629
Indiana,Clark,2019,61893,59835,2058
Indiana,Clay,2019,12124,11694,430
Indiana,Clinton,2019,17231,16769,462
Indiana,Crawford,2019,4874,4672,202
Indiana,Daviess,2019,16772,16337,435
Indiana,Dearborn,2019,25931,25010,921
Indiana,Decatur,2019,15052,14618,434
Indiana,DeKalb,2019,22758,22116,642
Indiana,Delaware,2019,53945,51853,2092
Indiana,Dubois,2019,23145,22590,555
Indiana,Elkhart,2019,112941,109468,3473
Indiana,Fayette,2019,8791,8375,416
Indiana,Floyd,2019,41797,40476,1321
Indiana,Fountain,2019,8060,7777,283
Indiana,Franklin,2019,11446,11052,394
Indiana,Fulton,2019,9916,9601,315
Indiana,Gibson,2019,19534,19043,491
Indiana,Grant,2019,31833,30648,1185
Indiana,Greene,2019,13728,13164,564
Indiana,Hamilton,2019,184661,180004,4657
Indiana,Hancock,2019,40470,39317,1153
Indiana,Harrison,2019,20386,19727,659
Indiana,Hendricks,2019,90412,87966,2446
Indiana,Henry,2019,22165,21435,730
Indiana,Howard,2019,36915,35432,1483
Indiana,Huntington,2019,18344,17745,599
Indiana,Jackson,2019,22962,22356,606
Indiana,Jasper,2019,16435,15831,604
Indiana,Jay,2019,9503,9216,287
Indiana,Jefferson,2019,15078,14567,511
Indiana,Jennings,2019,13599,13151,448
Indiana,Johnson,2019,83375,81134,2241
Indiana,Knox,2019,18584,18011,573
Indiana,Kosciusko,2019,42438,41248,1190
Indiana,LaGrange,2019,20073,19514,559
Indiana,Lake,2019,232451,221096,11355
Indiana,LaPorte,2019,48062,46012,2050
Indiana,Lawrence,2019,21247,20481,766
Indiana,Madison,2019,59452,57262,2190
Indiana,Marion,2019,492967,476851,16116
Indiana,Marshall,2019,23239,22513,726
Indiana,Martin,2019,5380,5239,141
Indiana,Miami,2019,15517,14911,606
Indiana,Monroe,2019,70338,68000,2338
Indiana,Montgomery,2019,18852,18275,577
Indiana,Morgan,2019,36532,35404,1128
Indiana,Newton,2019,7035,6746,289
Indiana,Noble,2019,23760,23023,737
Indiana,Ohio,2019,3201,3089,112
Indiana,Orange,2019,8653,8353,300
Indiana,Owen,2019,9413,9038,375
Indiana,Parke,2019,7116,6847,269
Indiana,Perry,2019,9306,8998,308
Indiana,Pike,2019,6151,5948,203
Indiana,Porter,2019,87566,84303,3263
Indiana,Posey,2019,13680,13306,374
Indiana,Pulaski,2019,6569,6367,202
Indiana,Putnam,2019,16868,16286,582
Indiana,Randolph,2019,11347,10922,425
Indiana,Ripley,2019,14326,13860,466
Indiana,Rush,2019,9004,8763,241
Indiana,Scott,2019,10600,10221,379
Indiana,Shelby,2019,23275,22600,675
Indiana,Spencer,2019,10841,10501,340
Indiana,St. Joseph,2019,136431,131498,4933
Indiana,Starke,2019,9963,9531,432
Indiana,Steuben,2019,20785,20232,553
Indiana,Sullivan,2019,8444,8085,359
Indiana,Switzerland,2019,5024,4857,167
Indiana,Tippecanoe,2019,99148,96245,2903
Indiana,Tipton,2019,9337,9084,253
Indiana,Union,2019,3574,3457,117
Indiana,Vanderburgh,2019,94928,92022,2906
Indiana,Vermillion,2019,7041,6675,366
Indiana,Vigo,2019,48492,46409,2083
Indiana,Wabash,2019,15101,14630,471
Indiana,Warren,2019,4225,4098,127
Indiana,Warrick,2019,33195,32233,962
Indiana,Washington,2019,13771,13315,456
Indiana,Wayne,2019,30881,29776,1105
Indiana,Wells,2019,14514,14123,391
Indiana,White,2019,13577,13210,367
Indiana,Whitley,2019,17881,17354,527
Iowa,Adair,2019,4281,4180,101
Iowa,Adams,2019,2209,2171,38
Iowa,Allamakee,2019,7490,7227,263
Iowa,Appanoose,2019,6044,5829,215
Iowa,Audubon,2019,3172,3093,79
Iowa,Benton,2019,13745,13339,406
Iowa,Black Hawk,2019,70280,68011,2269
Iowa,Boone,2019,15151,14791,360
Iowa,Bremer,2019,14103,13774,329
Iowa,Buchanan,2019,11481,11163,318
Iowa,Buena Vista,2019,11924,11673,251
Iowa,Butler,2019,8015,7758,257
Iowa,Calhoun,2019,4312,4202,110
Iowa,Carroll,2019,11106,10890,216
Iowa,Cass,2019,6998,6800,198
Iowa,Cedar,2019,11010,10738,272
Iowa,Cerro Gordo,2019,23919,23262,657
Iowa,Cherokee,2019,6243,6086,157
Iowa,Chickasaw,2019,6605,6416,189
Iowa,Clarke,2019,4943,4799,144
Iowa,Clay,2019,8624,8385,239
Iowa,Clayton,2019,10301,9925,376
Iowa,Clinton,2019,23154,22291,863
Iowa,Crawford,2019,8266,7971,295
Iowa,Dallas,2019,50365,49377,988
Iowa,Davis,2019,4263,4141,122
Iowa,Decatur,2019,4453,4354,99
Iowa,Delaware,2019,10720,10468,252
Iowa,Des Moines,2019,19587,18810,777
Iowa,Dickinson,2019,10228,9933,295
Iowa,Dubuque,2019,56937,55435,1502
Iowa,Emmet,2019,5332,5196,136
Iowa,Fayette,2019,10750,10367,383
Iowa,Floyd,2019,8977,8657,320
Iowa,Franklin,2019,5795,5659,136
Iowa,Fremont,2019,3732,3629,103
Iowa,Greene,2019,5499,5367,132
Iowa,Grundy,2019,6623,6440,183
Iowa,Guthrie,2019,5703,5533,170
Iowa,Hamilton,2019,7014,6814,200
Iowa,Hancock,2019,5995,5850,145
Iowa,Hardin,2019,8201,7939,262
Iowa,Harrison,2019,7480,7297,183
Iowa,Henry,2019,9932,9668,264
Iowa,Howard,2019,5256,5108,148
Iowa,Humboldt,2019,5190,5052,138
Iowa,Ida,2019,4190,4107,83
Iowa,Iowa,2019,10686,10450,236
Iowa,Jackson,2019,11166,10814,352
Iowa,Jasper,2019,20067,19478,589
Iowa,Jefferson,2019,10253,10002,251
Iowa,Johnson,2019,87724,85941,1783
Iowa,Jones,2019,10876,10532,344
Iowa,Keokuk,2019,5309,5136,173
Iowa,Kossuth,2019,8537,8347,190
Iowa,Lee,2019,16350,15706,644
Iowa,Linn,2019,124290,120668,3622
Iowa,Louisa,2019,6135,5947,188
Iowa,Lucas,2019,4700,4603,97
Iowa,Lyon,2019,7165,7047,118
Iowa,Madison,2019,8722,8404,318
Iowa,Mahaska,2019,12034,11729,305
Iowa,Marion,2019,18614,18215,399
Iowa,Marshall,2019,18204,17381,823
Iowa,Mills,2019,7509,7334,175
Iowa,Mitchell,2019,6952,6834,118
Iowa,Monona,2019,4509,4375,134
Iowa,Monroe,2019,4080,3955,125
Iowa,Montgomery,2019,5077,4942,135
Iowa,Muscatine,2019,22175,21539,636
Iowa,O'Brien,2019,8367,8186,181
Iowa,Osceola,2019,3578,3509,69
Iowa,Page,2019,6478,6310,168
Iowa,Palo Alto,2019,4855,4747,108
Iowa,Plymouth,2019,15033,14695,338
Iowa,Pocahontas,2019,4589,4501,88
Iowa,Polk,2019,273646,265893,7753
Iowa,Pottawattamie,2019,49299,48101,1198
Iowa,Poweshiek,2019,10539,10258,281
Iowa,Ringgold,2019,2511,2439,72
Iowa,Sac,2019,5363,5236,127
Iowa,Scott,2019,90711,87687,3024
Iowa,Shelby,2019,6801,6657,144
Iowa,Sioux,2019,21340,20939,401
Iowa,Story,2019,59215,58115,1100
Iowa,Tama,2019,9608,9308,300
Iowa,Taylor,2019,3247,3185,62
Iowa,Union,2019,6375,6169,206
Iowa,Van Buren,2019,3714,3613,101
Iowa,Wapello,2019,18068,17404,664
Iowa,Warren,2019,28783,28053,730
Iowa,Washington,2019,12211,11908,303
Iowa,Wayne,2019,2848,2774,74
Iowa,Webster,2019,19774,19159,615
Iowa,Winnebago,2019,5195,5051,144
Iowa,Winneshiek,2019,12125,11779,346
Iowa,Woodbury,2019,56509,54977,1532
Iowa,Worth,2019,4269,4149,120
Iowa,Wright,2019,7050,6867,183
Kansas,Allen,2019,6436,6209,227
Kansas,Anderson,2019,4178,4041,137
Kansas,Atchison,2019,6987,6626,361
Kansas,Barber,2019,2319,2261,58
Kansas,Barton,2019,13526,13103,423
Kansas,Bourbon,2019,6700,6416,284
Kansas,Brown,2019,5352,5183,169
Kansas,Butler,2019,32491,31442,1049
Kansas,Chase,2019,1524,1482,42
Kansas,Chautauqua,2019,1434,1378,56
Kansas,Cherokee,2019,10136,9788,348
Kansas,Cheyenne,2019,1310,1278,32
Kansas,Clark,2019,1072,1047,25
Kansas,Clay,2019,3777,3656,121
Kansas,Cloud,2019,3787,3665,122
Kansas,Coffey,2019,4023,3841,182
Kansas,Comanche,2019,869,846,23
Kansas,Cowley,2019,16298,15749,549
Kansas,Crawford,2019,18729,18003,726
Kansas,Decatur,2019,1235,1198,37
Kansas,Dickinson,2019,8842,8528,314
Kansas,Doniphan,2019,4143,4004,139
Kansas,Douglas,2019,65375,63457,1918
Kansas,Edwards,2019,1488,1450,38
Kansas,Elk,2019,1152,1109,43
Kansas,Ellis,2019,17036,16649,387
Kansas,Ellsworth,2019,2748,2671,77
Kansas,Finney,2019,20602,20121,481
Kansas,Ford,2019,17088,16664,424
Kansas,Franklin,2019,14023,13557,466
Kansas,Geary,2019,11311,10811,500
Kansas,Gove,2019,1468,1437,31
Kansas,Graham,2019,1114,1080,34
Kansas,Grant,2019,3218,3126,92
Kansas,Gray,2019,3230,3166,64
Kansas,Greeley,2019,798,780,18
Kansas,Greenwood,2019,3238,3136,102
Kansas,Hamilton,2019,1613,1583,30
Kansas,Harper,2019,2875,2802,73
Kansas,Harvey,2019,16990,16496,494
Kansas,Haskell,2019,2208,2158,50
Kansas,Hodgeman,2019,987,963,24
Kansas,Jackson,2019,7167,6959,208
Kansas,Jefferson,2019,10096,9788,308
Kansas,Jewell,2019,1291,1255,36
Kansas,Johnson,2019,338777,329456,9321
Kansas,Kearny,2019,2047,1999,48
Kansas,Kingman,2019,3434,3325,109
Kansas,Kiowa,2019,1297,1267,30
Kansas,Labette,2019,10029,9629,400
Kansas,Lane,2019,772,752,20
Kansas,Leavenworth,2019,36474,35225,1249
Kansas,Lincoln,2019,1681,1642,39
Kansas,Linn,2019,4440,4176,264
Kansas,Logan,2019,1623,1590,33
Kansas,Lyon,2019,16666,16099,567
Kansas,Marion,2019,5991,5814,177
Kansas,Marshall,2019,5492,5335,157
Kansas,McPherson,2019,17171,16789,382
Kansas,Meade,2019,2155,2105,50
Kansas,Miami,2019,17476,16898,578
Kansas,Mitchell,2019,3359,3279,80
Kansas,Montgomery,2019,14801,14196,605
Kansas,Morris,2019,2993,2912,81
Kansas,Morton,2019,1140,1107,33
Kansas,Nemaha,2019,5368,5220,148
Kansas,Neosho,2019,6130,5850,280
Kansas,Ness,2019,1342,1308,34
Kansas,Norton,2019,2700,2641,59
Kansas,Osage,2019,7973,7689,284
Kansas,Osborne,2019,2050,2009,41
Kansas,Ottawa,2019,3009,2927,82
Kansas,Pawnee,2019,2873,2791,82
Kansas,Phillips,2019,2638,2569,69
Kansas,Pottawatomie,2019,12410,12062,348
Kansas,Pratt,2019,4907,4783,124
Kansas,Rawlins,2019,1490,1457,33
Kansas,Reno,2019,29642,28692,950
Kansas,Republic,2019,2263,2205,58
Kansas,Rice,2019,5208,5063,145
Kansas,Riley,2019,35046,34062,984
Kansas,Rooks,2019,2538,2448,90
Kansas,Rush,2019,1632,1586,46
Kansas,Russell,2019,3296,3200,96
Kansas,Saline,2019,30176,29269,907
Kansas,Scott,2019,2832,2778,54
Kansas,Sedgwick,2019,251155,242477,8678
Kansas,Seward,2019,9516,9222,294
Kansas,Shawnee,2019,90410,87395,3015
Kansas,Sheridan,2019,1405,1374,31
Kansas,Sherman,2019,2844,2766,78
Kansas,Smith,2019,1973,1923,50
Kansas,Stafford,2019,2010,1956,54
Kansas,Stanton,2019,985,960,25
Kansas,Stevens,2019,2543,2476,67
Kansas,Sumner,2019,10903,10537,366
Kansas,Thomas,2019,4305,4208,97
Kansas,Trego,2019,1416,1376,40
Kansas,Wabaunsee,2019,3647,3529,118
Kansas,Wallace,2019,805,784,21
Kansas,Washington,2019,2915,2838,77
Kansas,Wichita,2019,1356,1329,27
Kansas,Wilson,2019,3947,3791,156
Kansas,Woodson,2019,1608,1540,68
Kansas,Wyandotte,2019,77251,73917,3334
Kentucky,Adair,2019,7140,6760,380
Kentucky,Allen,2019,9060,8682,378
Kentucky,Anderson,2019,12091,11643,448
Kentucky,Ballard,2019,3524,3323,201
Kentucky,Barren,2019,18852,18001,851
Kentucky,Bath,2019,4631,4343,288
Kentucky,Bell,2019,8452,7909,543
Kentucky,Boone,2019,71372,68948,2424
Kentucky,Bourbon,2019,9813,9441,372
Kentucky,Boyd,2019,17882,16869,1013
Kentucky,Boyle,2019,12586,11999,587
Kentucky,Bracken,2019,3843,3656,187
Kentucky,Breathitt,2019,3493,3231,262
Kentucky,Breckinridge,2019,7946,7523,423
Kentucky,Bullitt,2019,43068,41294,1774
Kentucky,Butler,2019,5133,4886,247
Kentucky,Caldwell,2019,5473,5200,273
Kentucky,Calloway,2019,18799,18032,767
Kentucky,Campbell,2019,51083,49301,1782
Kentucky,Carlisle,2019,2235,2142,93
Kentucky,Carroll,2019,5329,5117,212
Kentucky,Carter,2019,9783,8971,812
Kentucky,Casey,2019,6704,6424,280
Kentucky,Christian,2019,25085,23683,1402
Kentucky,Clark,2019,17255,16576,679
Kentucky,Clay,2019,5196,4831,365
Kentucky,Clinton,2019,4009,3788,221
Kentucky,Crittenden,2019,3810,3625,185
Kentucky,Cumberland,2019,3185,3051,134
Kentucky,Daviess,2019,47567,45730,1837
Kentucky,Edmonson,2019,4841,4602,239
Kentucky,Elliott,2019,2041,1873,168
Kentucky,Estill,2019,5388,5120,268
Kentucky,Fayette,2019,175864,170028,5836
Kentucky,Fleming,2019,6200,5866,334
Kentucky,Floyd,2019,11048,10340,708
Kentucky,Franklin,2019,25333,24392,941
Kentucky,Fulton,2019,2058,1941,117
Kentucky,Gallatin,2019,4109,3945,164
Kentucky,Garrard,2019,7710,7352,358
Kentucky,Grant,2019,11795,11307,488
Kentucky,Graves,2019,15849,15122,727
Kentucky,Grayson,2019,11029,10477,552
Kentucky,Green,2019,5125,4901,224
Kentucky,Greenup,2019,13444,12560,884
Kentucky,Hancock,2019,3994,3841,153
Kentucky,Hardin,2019,49305,47280,2025
Kentucky,Harlan,2019,6717,6072,645
Kentucky,Harrison,2019,8836,8457,379
Kentucky,Hart,2019,7960,7582,378
Kentucky,Henderson,2019,22116,21270,846
Kentucky,Henry,2019,8273,7970,303
Kentucky,Hickman,2019,1776,1690,86
Kentucky,Hopkins,2019,18562,17714,848
Kentucky,Jackson,2019,4132,3865,267
Kentucky,Jefferson,2019,402518,386373,16145
Kentucky,Jessamine,2019,26666,25695,971
Kentucky,Johnson,2019,6771,6324,447
Kentucky,Kenton,2019,88326,85189,3137
Kentucky,Knott,2019,4499,4189,310
Kentucky,Knox,2019,9946,9351,595
Kentucky,Larue,2019,6008,5737,271
Kentucky,Laurel,2019,24692,23483,1209
Kentucky,Lawrence,2019,5200,4833,367
Kentucky,Lee,2019,2064,1947,117
Kentucky,Leslie,2019,2704,2481,223
Kentucky,Letcher,2019,6333,5862,471
Kentucky,Lewis,2019,4654,4241,413
Kentucky,Lincoln,2019,9349,8877,472
Kentucky,Livingston,2019,3669,3459,210
Kentucky,Logan,2019,12621,12112,509
Kentucky,Lyon,2019,3119,2973,146
Kentucky,Madison,2019,47575,45743,1832
Kentucky,Magoffin,2019,3136,2790,346
Kentucky,Marion,2019,9744,9368,376
Kentucky,Marshall,2019,15138,14433,705
Kentucky,Martin,2019,2772,2582,190
Kentucky,Mason,2019,7134,6723,411
Kentucky,McCracken,2019,29258,27819,1439
Kentucky,McCreary,2019,4702,4418,284
Kentucky,McLean,2019,4233,4046,187
Kentucky,Meade,2019,12345,11775,570
Kentucky,Menifee,2019,2326,2165,161
Kentucky,Mercer,2019,10070,9602,468
Kentucky,Metcalfe,2019,4106,3909,197
Kentucky,Monroe,2019,4700,4516,184
Kentucky,Montgomery,2019,11705,11084,621
Kentucky,Morgan,2019,4588,4342,246
Kentucky,Muhlenberg,2019,10541,9890,651
Kentucky,Nelson,2019,23276,22217,1059
Kentucky,Nicholas,2019,3295,3149,146
Kentucky,Ohio,2019,9827,9326,501
Kentucky,Oldham,2019,33501,32403,1098
Kentucky,Owen,2019,5138,4902,236
Kentucky,Owsley,2019,1135,1055,80
Kentucky,Pendleton,2019,7021,6754,267
Kentucky,Perry,2019,8294,7792,502
Kentucky,Pike,2019,19977,18819,1158
Kentucky,Powell,2019,5046,4775,271
Kentucky,Pulaski,2019,26745,25493,1252
Kentucky,Robertson,2019,819,775,44
Kentucky,Rockcastle,2019,6718,6397,321
Kentucky,Rowan,2019,10456,9904,552
Kentucky,Russell,2019,6251,5894,357
Kentucky,Scott,2019,29281,28256,1025
Kentucky,Shelby,2019,25657,24781,876
Kentucky,Simpson,2019,8943,8538,405
Kentucky,Spencer,2019,10268,9903,365
Kentucky,Taylor,2019,12757,12212,545
Kentucky,Todd,2019,5447,5232,215
Kentucky,Trigg,2019,6024,5741,283
Kentucky,Trimble,2019,3902,3732,170
Kentucky,Union,2019,6139,5863,276
Kentucky,Warren,2019,65388,62844,2544
Kentucky,Washington,2019,6267,6022,245
Kentucky,Wayne,2019,7465,7033,432
Kentucky,Webster,2019,5790,5556,234
Kentucky,Whitley,2019,13737,13029,708
Kentucky,Wolfe,2019,1968,1828,140
Kentucky,Woodford,2019,14949,14481,468
Louisiana,Acadia Parish,2019,23841,22572,1269
Louisiana,Allen Parish,2019,8811,8312,499
Louisiana,Ascension Parish,2019,63953,61318,2635
Louisiana,Assumption Parish,2019,8877,8335,542
Louisiana,Avoyelles Parish,2019,15109,14226,883
Louisiana,Beauregard Parish,2019,14606,13849,757
Louisiana,Bienville Parish,2019,5516,5190,326
Louisiana,Bossier Parish,2019,57604,55129,2475
Louisiana,Caddo Parish,2019,103405,97859,5546
Louisiana,Calcasieu Parish,2019,106140,101802,4338
Louisiana,Caldwell Parish,2019,3773,3544,229
Louisiana,Cameron Parish,2019,3937,3789,148
Louisiana,Catahoula Parish,2019,3379,3162,217
Louisiana,Claiborne Parish,2019,5837,5506,331
Louisiana,Concordia Parish,2019,7019,6566,453
Louisiana,De Soto Parish,2019,10853,10201,652
Louisiana,East Baton Rouge Parish,2019,230493,220337,10156
Louisiana,East Carroll Parish,2019,1888,1688,200
Louisiana,East Feliciana Parish,2019,7973,7606,367
Louisiana,Evangeline Parish,2019,11889,11186,703
Louisiana,Franklin Parish,2019,7363,6834,529
Louisiana,Grant Parish,2019,8171,7696,475
Louisiana,Iberia Parish,2019,28099,26574,1525
Louisiana,Iberville Parish,2019,14040,13207,833
Louisiana,Jackson Parish,2019,6802,6480,322
Louisiana,Jefferson Davis Parish,2019,13231,12607,624
Louisiana,Jefferson Parish,2019,213704,204775,8929
Louisiana,Lafayette Parish,2019,113607,108685,4922
Louisiana,Lafourche Parish,2019,42008,40124,1884
Louisiana,LaSalle Parish,2019,6715,6429,286
Louisiana,Lincoln Parish,2019,21959,20780,1179
Louisiana,Livingston Parish,2019,68713,65912,2801
Louisiana,Madison Parish,2019,3515,3232,283
Louisiana,Morehouse Parish,2019,9999,9166,833
Louisiana,Natchitoches Parish,2019,16343,15356,987
Louisiana,Orleans Parish,2019,178834,170121,8713
Louisiana,Ouachita Parish,2019,70082,66346,3736
Louisiana,Plaquemines Parish,2019,10053,9620,433
Louisiana,Pointe Coupee Parish,2019,9867,9339,528
Louisiana,Rapides Parish,2019,55062,52258,2804
Louisiana,Red River Parish,2019,3745,3553,192
Louisiana,Richland Parish,2019,8222,7704,518
Louisiana,Sabine Parish,2019,9172,8705,467
Louisiana,St. Bernard Parish,2019,19854,18885,969
Louisiana,St. Charles Parish,2019,25134,24049,1085
Louisiana,St. Helena Parish,2019,4273,4013,260
Louisiana,St. James Parish,2019,9229,8675,554
Louisiana,St. John the Baptist Parish,2019,19647,18545,1102
Louisiana,St. Martin Parish,2019,22189,21056,1133
Louisiana,St. Mary Parish,2019,19816,18643,1173
Louisiana,St. Tammany Parish,2019,119300,114335,4965
Louisiana,Tangipahoa Parish,2019,54444,51437,3007
Louisiana,Tensas Parish,2019,1398,1282,116
Louisiana,Terrebonne Parish,2019,46285,44140,2145
Louisiana,Union Parish,2019,9098,8570,528
Louisiana,Vermilion Parish,2019,24087,22870,1217
Louisiana,Vernon Parish,2019,15883,14906,977
Louisiana,Washington Parish,2019,16703,15713,990
Louisiana,Webster Parish,2019,14493,13609,884
Louisiana,West Baton Rouge Parish,2019,13648,13029,619
Louisiana,West Carroll Parish,2019,3630,3243,387
Louisiana,West Feliciana Parish,2019,5378,5158,220
Louisiana,Winn Parish,2019,4867,4558,309
Maine,Androscoggin,2019,55225,53594,1631
Maine,Aroostook,2019,30205,28814,1391
Maine,Cumberland,2019,164832,160912,3920
Maine,Franklin,2019,14241,13693,548
Maine,Hancock,2019,29089,28064,1025
Maine,Kennebec,2019,61923,60100,1823
Maine,Knox,2019,20194,19605,589
Maine,Lincoln,2019,16789,16290,499
Maine,Oxford,2019,26333,25381,952
Maine,Penobscot,2019,76836,74339,2497
Maine,Piscataquis,2019,7274,7003,271
Maine,Sagadahoc,2019,19421,18975,446
Maine,Somerset,2019,22429,21428,1001
Maine,Waldo,2019,20613,19953,660
Maine,Washington,2019,13688,13053,635
Maine,York,2019,113644,110554,3090
Maryland,Allegany,2019,32491,30812,1679
Maryland,Anne Arundel,2019,317780,308068,9712
Maryland,Baltimore,2019,290743,275911,14832
Maryland,Baltimore,2019,457555,440638,16917
Maryland,Calvert,2019,50484,48888,1596
Maryland,Caroline,2019,18270,17612,658
Maryland,Carroll,2019,96466,93645,2821
Maryland,Cecil,2019,53453,51323,2130
Maryland,Charles,2019,88102,84908,3194
Maryland,Dorchester,2019,15684,14938,746
Maryland,Frederick,2019,135761,131453,4308
Maryland,Garrett,2019,15775,15075,700
Maryland,Harford,2019,142081,137331,4750
Maryland,Howard,2019,189135,183944,5191
Maryland,Kent,2019,10205,9796,409
Maryland,Montgomery,2019,565866,549310,16556
Maryland,Prince George's,2019,513953,494665,19288
Maryland,Queen Anne's,2019,28079,27210,869
Maryland,Somerset,2019,9252,8689,563
Maryland,St. Mary's,2019,57409,55506,1903
Maryland,Talbot,2019,19327,18665,662
Maryland,Washington,2019,75259,72347,2912
Maryland,Wicomico,2019,51724,49327,2397
Maryland,Worcester,2019,25814,23908,1906
Massachusetts,Barnstable,2019,115437,110989,4448
Massachusetts,Berkshire,2019,65320,63035,2285
Massachusetts,Bristol,2019,304217,292890,11327
Massachusetts,Dukes,2019,9650,9255,395
Massachusetts,Essex,2019,429871,417092,12779
Massachusetts,Franklin,2019,41318,40207,1111
Massachusetts,Hampden,2019,230190,220767,9423
Massachusetts,Hampshire,2019,90937,88479,2458
Massachusetts,Middlesex,2019,929265,907777,21488
Massachusetts,Nantucket,2019,7661,7342,319
Massachusetts,Norfolk,2019,395483,385482,10001
Massachusetts,Plymouth,2019,286588,277913,8675
Massachusetts,Suffolk,2019,461168,449136,12032
Massachusetts,Worcester,2019,450332,436193,14139
Michigan,Alcona,2019,3879,3635,244
Michigan,Alger,2019,3198,2949,249
Michigan,Allegan,2019,62275,60325,1950
Michigan,Alpena,2019,13266,12638,628
Michigan,Antrim,2019,10321,9791,530
Michigan,Arenac,2019,6062,5663,399
Michigan,Baraga,2019,3219,3015,204
Michigan,Barry,2019,31665,30638,1027
Michigan,Bay,2019,50038,47704,2334
Michigan,Benzie,2019,8882,8432,450
Michigan,Berrien,2019,73454,70483,2971
Michigan,Branch,2019,19356,18600,756
Michigan,Calhoun,2019,62502,59943,2559
Michigan,Cass,2019,24491,23442,1049
Michigan,Charlevoix,2019,12913,12315,598
Michigan,Cheboygan,2019,10547,9627,920
Michigan,Chippewa,2019,16031,15022,1009
Michigan,Clare,2019,11728,11010,718
Michigan,Clinton,2019,41149,39916,1233
Michigan,Crawford,2019,5599,5285,314
Michigan,Delta,2019,17181,16282,899
Michigan,Dickinson,2019,12297,11777,520
Michigan,Eaton,2019,57251,55295,1956
Michigan,Emmet,2019,17772,16816,956
Michigan,Genesee,2019,182899,173888,9011
Michigan,Gladwin,2019,9918,9350,568
Michigan,Gogebic,2019,6030,5714,316
Michigan,Grand Traverse,2019,49812,48097,1715
Michigan,Gratiot,2019,17998,17209,789
Michigan,Hillsdale,2019,20446,19592,854
Michigan,Houghton,2019,16183,15388,795
Michigan,Huron,2019,15401,14723,678
Michigan,Ingham,2019,151261,145943,5318
Michigan,Ionia,2019,30280,29252,1028
Michigan,Iosco,2019,10220,9610,610
Michigan,Iron,2019,5162,4878,284
Michigan,Isabella,2019,34741,33405,1336
Michigan,Jackson,2019,74125,71335,2790
Michigan,Kalamazoo,2019,133718,129316,4402
Michigan,Kalkaska,2019,7935,7487,448
Michigan,Kent,2019,359924,349535,10389
Michigan,Keweenaw,2019,884,823,61
Michigan,Lake,2019,3709,3472,237
Michigan,Lapeer,2019,41517,39273,2244
Michigan,Leelanau,2019,10531,10139,392
Michigan,Lenawee,2019,46454,44663,1791
Michigan,Livingston,2019,104220,100768,3452
Michigan,Luce,2019,2315,2172,143
Michigan,Mackinac,2019,5135,4656,479
Michigan,Macomb,2019,451125,432001,19124
Michigan,Manistee,2019,10444,9873,571
Michigan,Marquette,2019,32543,30975,1568
Michigan,Mason,2019,13666,12996,670
Michigan,Mecosta,2019,18247,17390,857
Michigan,Menominee,2019,11054,10612,442
Michigan,Midland,2019,40325,38826,1499
Michigan,Missaukee,2019,6961,6629,332
Michigan,Monroe,2019,75480,72541,2939
Michigan,Montcalm,2019,28350,27196,1154
Michigan,Montmorency,2019,2998,2748,250
Michigan,Muskegon,2019,77149,73860,3289
Michigan,Newaygo,2019,23400,22413,987
Michigan,Oakland,2019,680255,657035,23220
Michigan,Oceana,2019,12120,11403,717
Michigan,Ogemaw,2019,8030,7494,536
Michigan,Ontonagon,2019,2090,1947,143
Michigan,Osceola,2019,11202,10749,453
Michigan,Oscoda,2019,3045,2836,209
Michigan,Otsego,2019,11638,11062,576
Michigan,Ottawa,2019,161102,156664,4438
Michigan,Presque Isle,2019,4951,4576,375
Michigan,Roscommon,2019,7726,7145,581
Michigan,Saginaw,2019,86666,82533,4133
Michigan,Sanilac,2019,19490,18565,925
Michigan,Schoolcraft,2019,3326,3093,233
Michigan,Shiawassee,2019,33496,32070,1426
Michigan,St. Clair,2019,76280,72546,3734
Michigan,St. Joseph,2019,27976,26783,1193
Michigan,Tuscola,2019,23853,22635,1218
Michigan,Van Buren,2019,35167,33559,1608
Michigan,Washtenaw,2019,198198,192472,5726
Michigan,Wayne,2019,808171,767123,41048
Michigan,Wexford,2019,14854,14185,669
Minnesota,Aitkin,2019,7268,6818,450
Minnesota,Anoka,2019,199416,193301,6115
Minnesota,Becker,2019,18833,18086,747
Minnesota,Beltrami,2019,24532,23487,1045
Minnesota,Benton,2019,22144,21287,857
Minnesota,Big Stone,2019,2507,2402,105
Minnesota,Blue Earth,2019,40878,39748,1130
Minnesota,Brown,2019,14435,13912,523
Minnesota,Carlton,2019,17927,17126,801
Minnesota,Carver,2019,59102,57473,1629
Minnesota,Cass,2019,14467,13668,799
Minnesota,Chippewa,2019,6978,6707,271
Minnesota,Chisago,2019,30246,29106,1140
Minnesota,Clay,2019,36268,35165,1103
Minnesota,Clearwater,2019,4501,4130,371
Minnesota,Cook,2019,3123,2988,135
Minnesota,Cottonwood,2019,5963,5743,220
Minnesota,Crow Wing,2019,32410,31005,1405
Minnesota,Dakota,2019,243793,236782,7011
Minnesota,Dodge,2019,11982,11577,405
Minnesota,Douglas,2019,21134,20466,668
Minnesota,Faribault,2019,7077,6783,294
Minnesota,Fillmore,2019,11664,11279,385
Minnesota,Freeborn,2019,16216,15659,557
Minnesota,Goodhue,2019,27240,26410,830
Minnesota,Grant,2019,3324,3176,148
Minnesota,Hennepin,2019,712531,692855,19676
Minnesota,Houston,2019,10451,10115,336
Minnesota,Hubbard,2019,10036,9495,541
Minnesota,Isanti,2019,21503,20632,871
Minnesota,Itasca,2019,21963,20656,1307
Minnesota,Jackson,2019,5754,5556,198
Minnesota,Kanabec,2019,9111,8573,538
Minnesota,Kandiyohi,2019,24425,23565,860
Minnesota,Kittson,2019,2386,2299,87
Minnesota,Koochiching,2019,5990,5608,382
Minnesota,Lac qui Parle,2019,3579,3445,134
Minnesota,Lake,2019,5538,5338,200
Minnesota,Lake of the Woods,2019,2472,2370,102
Minnesota,Le Sueur,2019,16307,15576,731
Minnesota,Lincoln,2019,3290,3166,124
Minnesota,Lyon,2019,14631,14163,468
Minnesota,Mahnomen,2019,2305,2196,109
Minnesota,Marshall,2019,5447,5128,319
Minnesota,Martin,2019,10145,9764,381
Minnesota,McLeod,2019,19408,18690,718
Minnesota,Meeker,2019,13426,12907,519
Minnesota,Morrison,2019,17653,16738,915
Minnesota,Mower,2019,20463,19842,621
Minnesota,Murray,2019,4877,4668,209
Minnesota,Nicollet,2019,21098,20564,534
Minnesota,Nobles,2019,11289,10950,339
Minnesota,Norman,2019,3284,3127,157
Minnesota,Olmsted,2019,89236,86958,2278
Minnesota,Otter Tail,2019,31655,30335,1320
Minnesota,Pennington,2019,8765,8365,400
Minnesota,Pine,2019,15154,14318,836
Minnesota,Pipestone,2019,4950,4778,172
Minnesota,Polk,2019,16672,16007,665
Minnesota,Pope,2019,6582,6378,204
Minnesota,Ramsey,2019,292118,283424,8694
Minnesota,Redwood,2019,7676,7392,284
Minnesota,Renville,2019,8669,8275,394
Minnesota,Rice,2019,37333,36169,1164
Minnesota,Rock,2019,5687,5556,131
Minnesota,Roseau,2019,7875,7570,305
Minnesota,Scott,2019,84276,81967,2309
Minnesota,Sherburne,2019,52921,51063,1858
Minnesota,Sibley,2019,8661,8331,330
Minnesota,St. Louis,2019,102395,98297,4098
Minnesota,Stearns,2019,91177,88280,2897
Minnesota,Steele,2019,21221,20549,672
Minnesota,Stevens,2019,5478,5330,148
Minnesota,Swift,2019,4953,4737,216
Minnesota,Todd,2019,13615,13012,603
Minnesota,Traverse,2019,1781,1715,66
Minnesota,Wabasha,2019,12432,12018,414
Minnesota,Wadena,2019,5962,5595,367
Minnesota,Waseca,2019,9059,8709,350
Minnesota,Washington,2019,144620,140553,4067
Minnesota,Watonwan,2019,6531,6267,264
Minnesota,Wilkin,2019,3516,3397,119
Minnesota,Winona,2019,28840,28005,835
Minnesota,Wright,2019,76368,73883,2485
Minnesota,Yellow Medicine,2019,5409,5204,205
Mississippi,Adams,2019,11260,10466,794
Mississippi,Alcorn,2019,16057,15300,757
Mississippi,Amite,2019,4417,4109,308
Mississippi,Attala,2019,7031,6592,439
Mississippi,Benton,2019,3055,2868,187
Mississippi,Bolivar,2019,12260,11397,863
Mississippi,Calhoun,2019,5660,5350,310
Mississippi,Carroll,2019,3471,3253,218
Mississippi,Chickasaw,2019,6921,6531,390
Mississippi,Choctaw,2019,3757,3552,205
Mississippi,Claiborne,2019,3030,2705,325
Mississippi,Clarke,2019,5923,5554,369
Mississippi,Clay,2019,7794,7213,581
Mississippi,Coahoma,2019,8364,7722,642
Mississippi,Copiah,2019,11233,10490,743
Mississippi,Covington,2019,8143,7745,398
Mississippi,DeSoto,2019,91399,87382,4017
Mississippi,Forrest,2019,33282,31575,1707
Mississippi,Franklin,2019,2807,2616,191
Mississippi,George,2019,8841,8185,656
Mississippi,Greene,2019,4355,4014,341
Mississippi,Grenada,2019,9494,9014,480
Mississippi,Hancock,2019,18776,17720,1056
Mississippi,Harrison,2019,86479,82022,4457
Mississippi,Hinds,2019,107145,101524,5621
Mississippi,Holmes,2019,5672,5089,583
Mississippi,Humphreys,2019,2227,2003,224
Mississippi,Issaquena,2019,381,338,43
Mississippi,Itawamba,2019,10529,10034,495
Mississippi,Jackson,2019,58591,55058,3533
Mississippi,Jasper,2019,6185,5762,423
Mississippi,Jefferson,2019,2028,1714,314
Mississippi,Jefferson Davis,2019,4124,3840,284
Mississippi,Jones,2019,26252,24839,1413
Mississippi,Kemper,2019,3555,3271,284
Mississippi,Lafayette,2019,28393,27113,1280
Mississippi,Lamar,2019,30722,29435,1287
Mississippi,Lauderdale,2019,30536,28862,1674
Mississippi,Lawrence,2019,4623,4310,313
Mississippi,Leake,2019,7968,7527,441
Mississippi,Lee,2019,41209,39409,1800
Mississippi,Leflore,2019,10018,9262,756
Mississippi,Lincoln,2019,14635,13813,822
Mississippi,Lowndes,2019,25441,24086,1355
Mississippi,Madison,2019,53328,51001,2327
Mississippi,Marion,2019,9940,9397,543
Mississippi,Marshall,2019,14505,13673,832
Mississippi,Monroe,2019,15534,14683,851
Mississippi,Montgomery,2019,3960,3721,239
Mississippi,Neshoba,2019,10244,9640,604
Mississippi,Newton,2019,8856,8371,485
Mississippi,Noxubee,2019,3783,3507,276
Mississippi,Oktibbeha,2019,22722,21447,1275
Mississippi,Panola,2019,12553,11726,827
Mississippi,Pearl River,2019,23847,22609,1238
Mississippi,Perry,2019,4293,4004,289
Mississippi,Pike,2019,14519,13575,944
Mississippi,Pontotoc,2019,14773,14133,640
Mississippi,Prentiss,2019,11338,10781,557
Mississippi,Quitman,2019,2378,2182,196
Mississippi,Rankin,2019,76230,73226,3004
Mississippi,Scott,2019,12721,12149,572
Mississippi,Sharkey,2019,1604,1469,135
Mississippi,Simpson,2019,10765,10209,556
Mississippi,Smith,2019,6822,6466,356
Mississippi,Stone,2019,6876,6425,451
Mississippi,Sunflower,2019,7736,7051,685
Mississippi,Tallahatchie,2019,5276,4970,306
Mississippi,Tate,2019,12394,11696,698
Mississippi,Tippah,2019,9442,8960,482
Mississippi,Tishomingo,2019,8629,8189,440
Mississippi,Tunica,2019,4459,4183,276
Mississippi,Union,2019,14222,13628,594
Mississippi,Walthall,2019,4933,4574,359
Mississippi,Warren,2019,20335,19109,1226
Mississippi,Washington,2019,16985,15701,1284
Mississippi,Wayne,2019,7444,6990,454
Mississippi,Webster,2019,3987,3762,225
Mississippi,Wilkinson,2019,2811,2526,285
Mississippi,Winston,2019,7425,6973,452
Mississippi,Yalobusha,2019,4983,4698,285
Mississippi,Yazoo,2019,9424,8825,599
Missouri,Adair,2019,10345,9945,400
Missouri,Andrew,2019,9767,9494,273
Missouri,Atchison,2019,2703,2603,100
Missouri,Audrain,2019,10697,10337,360
Missouri,Barry,2019,15589,15044,545
Missouri,Barton,2019,5202,5026,176
Missouri,Bates,2019,7908,7590,318
Missouri,Benton,2019,7201,6855,346
Missouri,Bollinger,2019,5484,5270,214
Missouri,Boone,2019,98300,95937,2363
Missouri,Buchanan,2019,44669,43301,1368
Missouri,Butler,2019,17986,17140,846
Missouri,Caldwell,2019,4369,4230,139
Missouri,Callaway,2019,21383,20758,625
Missouri,Camden,2019,18861,18013,848
Missouri,Cape Girardeau,2019,40851,39654,1197
Missouri,Carroll,2019,4808,4653,155
Missouri,Carter,2019,2546,2421,125
Missouri,Cass,2019,54895,53239,1656
Missouri,Cedar,2019,5764,5550,214
Missouri,Chariton,2019,3727,3614,113
Missouri,Christian,2019,44998,43771,1227
Missouri,Clark,2019,3205,3091,114
Missouri,Clay,2019,136610,132701,3909
Missouri,Clinton,2019,10738,10414,324
Missouri,Cole,2019,39051,38037,1014
Missouri,Cooper,2019,7481,7205,276
Missouri,Crawford,2019,10980,10566,414
Missouri,Dade,2019,3545,3434,111
Missouri,Dallas,2019,7081,6762,319
Missouri,Daviess,2019,4102,3965,137
Missouri,DeKalb,2019,4838,4689,149
Missouri,Dent,2019,6269,6044,225
Missouri,Douglas,2019,5107,4849,258
Missouri,Dunklin,2019,11598,10956,642
Missouri,Franklin,2019,53226,51511,1715
Missouri,Gasconade,2019,7732,7470,262
Missouri,Gentry,2019,3529,3433,96
Missouri,Greene,2019,151535,147461,4074
Missouri,Grundy,2019,4394,4240,154
Missouri,Harrison,2019,3822,3695,127
Missouri,Henry,2019,9728,9364,364
Missouri,Hickory,2019,3842,3681,161
Missouri,Holt,2019,2588,2515,73
Missouri,Howard,2019,4898,4746,152
Missouri,Howell,2019,16541,15870,671
Missouri,Iron,2019,3534,3365,169
Missouri,Jackson,2019,363539,350008,13531
Missouri,Jasper,2019,57304,55590,1714
Missouri,Jefferson,2019,118177,114498,3679
Missouri,Johnson,2019,23105,22247,858
Missouri,Knox,2019,1772,1720,52
Missouri,Laclede,2019,17386,16190,1196
Missouri,Lafayette,2019,16847,16328,519
Missouri,Lawrence,2019,18018,17385,633
Missouri,Lewis,2019,5003,4843,160
Missouri,Lincoln,2019,28448,27497,951
Missouri,Linn,2019,5124,4875,249
Missouri,Livingston,2019,7357,7170,187
Missouri,Macon,2019,7535,7280,255
Missouri,Madison,2019,5484,5295,189
Missouri,Maries,2019,3884,3747,137
Missouri,Marion,2019,14565,14104,461
Missouri,McDonald,2019,10690,10334,356
Missouri,Mercer,2019,1861,1802,59
Missouri,Miller,2019,12313,11850,463
Missouri,Mississippi,2019,5792,5555,237
Missouri,Moniteau,2019,7313,7097,216
Missouri,Monroe,2019,3872,3711,161
Missouri,Montgomery,2019,5738,5558,180
Missouri,Morgan,2019,8127,7776,351
Missouri,New Madrid,2019,8236,7880,356
Missouri,Newton,2019,27392,26498,894
Missouri,Nodaway,2019,10790,10468,322
Missouri,Oregon,2019,3981,3824,157
Missouri,Osage,2019,7106,6936,170
Missouri,Ozark,2019,3412,3214,198
Missouri,Pemiscot,2019,6364,6043,321
Missouri,Perry,2019,10065,9801,264
Missouri,Pettis,2019,20971,20227,744
Missouri,Phelps,2019,19828,19177,651
Missouri,Pike,2019,7492,7224,268
Missouri,Platte,2019,58805,57239,1566
Missouri,Polk,2019,14584,14081,503
Missouri,Pulaski,2019,14692,14094,598
Missouri,Putnam,2019,2291,2207,84
Missouri,Ralls,2019,5662,5484,178
Missouri,Randolph,2019,10380,9978,402
Missouri,Ray,2019,11033,10632,401
Missouri,Reynolds,2019,3042,2929,113
Missouri,Ripley,2019,5039,4761,278
Missouri,Saline,2019,10608,10267,341
Missouri,Schuyler,2019,1948,1862,86
Missouri,Scotland,2019,2384,2311,73
Missouri,Scott,2019,20000,19293,707
Missouri,Shannon,2019,3228,3048,180
Missouri,Shelby,2019,3061,2970,91
Missouri,St. Charles,2019,227085,221305,5780
Missouri,St. Clair,2019,3749,3577,172
Missouri,St. Francois,2019,26637,25658,979
Missouri,St. Louis,2019,153066,147111,5955
Missouri,St. Louis,2019,533085,516722,16363
Missouri,Ste. Genevieve,2019,9197,8950,247
Missouri,Stoddard,2019,13098,12480,618
Missouri,Stone,2019,13873,13185,688
Missouri,Sullivan,2019,2684,2589,95
Missouri,Taney,2019,27142,25753,1389
Missouri,Texas,2019,9009,8607,402
Missouri,Vernon,2019,9466,9133,333
Missouri,Warren,2019,17971,17446,525
Missouri,Washington,2019,10241,9780,461
Missouri,Wayne,2019,5306,5050,256
Missouri,Webster,2019,17309,16692,617
Missouri,Worth,2019,1169,1138,31
Missouri,Wright,2019,7495,7101,394
Montana,Beaverhead,2019,5071,4922,149
Montana,Big Horn,2019,4832,4475,357
Montana,Blaine,2019,2487,2399,88
Montana,Broadwater,2019,2585,2482,103
Montana,Carbon,2019,5482,5293,189
Montana,Carter,2019,644,626,18
Montana,Cascade,2019,37939,36651,1288
Montana,Chouteau,2019,2455,2389,66
Montana,Custer,2019,6060,5886,174
Montana,Daniels,2019,893,875,18
Montana,Dawson,2019,4578,4467,111
Montana,Deer Lodge,2019,5038,4877,161
Montana,Fallon,2019,1704,1674,30
Montana,Fergus,2019,6044,5856,188
Montana,Flathead,2019,47892,45646,2246
Montana,Gallatin,2019,68760,67205,1555
Montana,Garfield,2019,738,720,18
Montana,Glacier,2019,5693,5266,427
Montana,Granite,2019,1687,1591,96
Montana,Hill,2019,7641,7360,281
Montana,Jefferson,2019,5698,5509,189
Montana,Judith Basin,2019,948,919,29
Montana,Lake,2019,13201,12644,557
Montana,Lewis and Clark,2019,35824,34759,1065
Montana,Liberty,2019,953,929,24
Montana,Lincoln,2019,8085,7499,586
Montana,Madison,2019,4808,4654,154
Montana,McCone,2019,951,932,19
Montana,Meagher,2019,955,922,33
Montana,Mineral,2019,1757,1657,100
Montana,Missoula,2019,63825,61776,2049
Montana,Musselshell,2019,2265,2177,88
Montana,Park,2019,8911,8606,305
Montana,Petroleum,2019,279,269,10
Montana,Phillips,2019,1883,1813,70
Montana,Pondera,2019,2671,2570,101
Montana,Powder River,2019,959,936,23
Montana,Powell,2019,2973,2865,108
Montana,Prairie,2019,477,459,18
Montana,Ravalli,2019,20230,19411,819
Montana,Richland,2019,5880,5724,156
Montana,Roosevelt,2019,4502,4308,194
Montana,Rosebud,2019,3827,3635,192
Montana,Sanders,2019,4844,4559,285
Montana,Sheridan,2019,1741,1702,39
Montana,Silver Bow,2019,17191,16542,649
Montana,Stillwater,2019,5180,5018,162
Montana,Sweet Grass,2019,1798,1748,50
Montana,Teton,2019,2740,2650,90
Montana,Toole,2019,2115,2064,51
Montana,Treasure,2019,334,325,9
Montana,Valley,2019,4079,3950,129
Montana,Wheatland,2019,785,755,30
Montana,Wibaux,2019,463,449,14
Montana,Yellowstone,2019,81781,79173,2608
Nebraska,Adams,2019,16792,16262,530
Nebraska,Antelope,2019,3558,3467,91
Nebraska,Arthur,2019,224,212,12
Nebraska,Banner,2019,377,363,14
Nebraska,Blaine,2019,259,246,13
Nebraska,Boone,2019,2963,2882,81
Nebraska,Box Butte,2019,5419,5247,172
Nebraska,Boyd,2019,1078,1042,36
Nebraska,Brown,2019,1393,1344,49
Nebraska,Buffalo,2019,27777,27048,729
Nebraska,Burt,2019,3483,3366,117
Nebraska,Butler,2019,4591,4472,119
Nebraska,Cass,2019,13570,13117,453
Nebraska,Cedar,2019,4515,4402,113
Nebraska,Chase,2019,2277,2225,52
Nebraska,Cherry,2019,3389,3308,81
Nebraska,Cheyenne,2019,4416,4253,163
Nebraska,Clay,2019,3298,3192,106
Nebraska,Colfax,2019,5581,5429,152
Nebraska,Cuming,2019,4696,4571,125
Nebraska,Custer,2019,6416,6261,155
Nebraska,Dakota,2019,10791,10369,422
Nebraska,Dawes,2019,4978,4832,146
Nebraska,Dawson,2019,13056,12667,389
Nebraska,Deuel,2019,957,929,28
Nebraska,Dixon,2019,3034,2941,93
Nebraska,Dodge,2019,19501,18931,570
Nebraska,Douglas,2019,299587,289816,9771
Nebraska,Dundy,2019,1171,1141,30
Nebraska,Fillmore,2019,3162,3080,82
Nebraska,Franklin,2019,1459,1409,50
Nebraska,Frontier,2019,1613,1560,53
Nebraska,Furnas,2019,2583,2511,72
Nebraska,Gage,2019,11010,10619,391
Nebraska,Garden,2019,1103,1071,32
Nebraska,Garfield,2019,1168,1137,31
Nebraska,Gosper,2019,1109,1080,29
Nebraska,Grant,2019,424,412,12
Nebraska,Greeley,2019,1222,1186,36
Nebraska,Hall,2019,31903,30801,1102
Nebraska,Hamilton,2019,4769,4624,145
Nebraska,Harlan,2019,1796,1745,51
Nebraska,Hayes,2019,613,598,15
Nebraska,Hitchcock,2019,1266,1223,43
Nebraska,Holt,2019,5763,5613,150
Nebraska,Hooker,2019,417,404,13
Nebraska,Howard,2019,3365,3247,118
Nebraska,Jefferson,2019,4143,4030,113
Nebraska,Johnson,2019,2064,1992,72
Nebraska,Kearney,2019,3791,3705,86
Nebraska,Keith,2019,4592,4444,148
Nebraska,Keya Paha,2019,589,574,15
Nebraska,Kimball,2019,2031,1970,61
Nebraska,Knox,2019,4611,4473,138
Nebraska,Lancaster,2019,177186,172276,4910
Nebraska,Lincoln,2019,18327,17689,638
Nebraska,Logan,2019,473,459,14
Nebraska,Loup,2019,405,389,16
Nebraska,Madison,2019,19816,19258,558
Nebraska,McPherson,2019,443,431,12
Nebraska,Merrick,2019,4013,3885,128
Nebraska,Morrill,2019,2607,2532,75
Nebraska,Nance,2019,1976,1917,59
Nebraska,Nemaha,2019,3603,3471,132
Nebraska,Nuckolls,2019,2404,2340,64
Nebraska,Otoe,2019,8429,8159,270
Nebraska,Pawnee,2019,1478,1435,43
Nebraska,Perkins,2019,1821,1779,42
Nebraska,Phelps,2019,4969,4838,131
Nebraska,Pierce,2019,4095,3985,110
Nebraska,Platte,2019,17668,17153,515
Nebraska,Polk,2019,2931,2850,81
Nebraska,Red Willow,2019,5850,5689,161
Nebraska,Richardson,2019,4238,4103,135
Nebraska,Rock,2019,871,844,27
Nebraska,Saline,2019,7372,7133,239
Nebraska,Sarpy,2019,96599,93801,2798
Nebraska,Saunders,2019,11169,10858,311
Nebraska,Scotts Bluff,2019,18287,17614,673
Nebraska,Seward,2019,8931,8669,262
Nebraska,Sheridan,2019,2673,2599,74
Nebraska,Sherman,2019,1691,1637,54
Nebraska,Sioux,2019,746,725,21
Nebraska,Stanton,2019,3507,3416,91
Nebraska,Thayer,2019,2787,2713,74
Nebraska,Thomas,2019,423,408,15
Nebraska,Thurston,2019,3058,2920,138
Nebraska,Valley,2019,2125,2057,68
Nebraska,Washington,2019,11279,10950,329
Nebraska,Wayne,2019,5749,5599,150
Nebraska,Webster,2019,1678,1619,59
Nebraska,Wheeler,2019,572,556,16
Nebraska,York,2019,7278,7083,195
Nevada,Carson City,2019,26282,25248,1034
Nevada,Churchill,2019,11057,10666,391
Nevada,Clark,2019,1131551,1085793,45758
Nevada,Douglas,2019,23210,22300,910
Nevada,Elko,2019,27362,26549,813
Nevada,Esmeralda,2019,434,418,16
Nevada,Eureka,2019,1095,1069,26
Nevada,Humboldt,2019,8251,8009,242
Nevada,Lander,2019,3214,3112,102
Nevada,Lincoln,2019,2113,2029,84
Nevada,Lyon,2019,23407,22309,1098
Nevada,Mineral,2019,2030,1948,82
Nevada,Nye,2019,17297,16415,882
Nevada,Pershing,2019,2563,2460,103
Nevada,Storey,2019,2038,1962,76
Nevada,Washoe,2019,255915,247691,8224
Nevada,White Pine,2019,4636,4499,137
New Hampshire,Belknap,2019,31583,30787,796
New Hampshire,Carroll,2019,23974,23366,608
New Hampshire,Cheshire,2019,40926,39856,1070
New Hampshire,Coos,2019,14741,14273,468
New Hampshire,Grafton,2019,49880,48784,1096
New Hampshire,Hillsborough,2019,242579,236216,6363
New Hampshire,Merrimack,2019,83845,81955,1890
New Hampshire,Rockingham,2019,188440,183326,5114
New Hampshire,Strafford,2019,74621,72875,1746
New Hampshire,Sullivan,2019,23145,22616,529
New Jersey,Atlantic,2019,120728,114622,6106
New Jersey,Bergen,2019,482038,467946,14092
New Jersey,Burlington,2019,230589,223049,7540
New Jersey,Camden,2019,253053,242811,10242
New Jersey,Cape May,2019,45947,42660,3287
New Jersey,Cumberland,2019,65061,61481,3580
New Jersey,Essex,2019,368748,352334,16414
New Jersey,Gloucester,2019,149747,144238,5509
New Jersey,Hudson,2019,361189,349372,11817
New Jersey,Hunterdon,2019,64523,62742,1781
New Jersey,Mercer,2019,202885,196458,6427
New Jersey,Middlesex,2019,439073,425471,13602
New Jersey,Monmouth,2019,328661,318233,10428
New Jersey,Morris,2019,256698,249463,7235
New Jersey,Ocean,2019,275023,264876,10147
New Jersey,Passaic,2019,242208,231779,10429
New Jersey,Salem,2019,29180,27771,1409
New Jersey,Somerset,2019,171371,166229,5142
New Jersey,Sussex,2019,73963,71425,2538
New Jersey,Union,2019,276382,266189,10193
New Jersey,Warren,2019,56060,54185,1875
New Mexico,Bernalillo,2019,333865,319048,14817
New Mexico,Catron,2019,1153,1081,72
New Mexico,Chaves,2019,27165,25839,1326
New Mexico,Cibola,2019,8991,8425,566
New Mexico,Colfax,2019,5483,5226,257
New Mexico,Curry,2019,21680,20783,897
New Mexico,De Baca,2019,795,761,34
New Mexico,Dona Ana,2019,97527,91976,5551
New Mexico,Eddy,2019,34483,33419,1064
New Mexico,Grant,2019,12228,11639,589
New Mexico,Guadalupe,2019,1549,1467,82
New Mexico,Harding,2019,273,259,14
New Mexico,Hidalgo,2019,2091,2002,89
New Mexico,Lea,2019,31282,30054,1228
New Mexico,Lincoln,2019,8984,8570,414
New Mexico,Los Alamos,2019,9463,9163,300
New Mexico,Luna,2019,10309,9047,1262
New Mexico,McKinley,2019,24155,22458,1697
New Mexico,Mora,2019,2213,2080,133
New Mexico,Otero,2019,24798,23575,1223
New Mexico,Quay,2019,3229,3062,167
New Mexico,Rio Arriba,2019,16835,15951,884
New Mexico,Roosevelt,2019,7901,7545,356
New Mexico,San Juan,2019,51941,48974,2967
New Mexico,San Miguel,2019,10809,10177,632
New Mexico,Sandoval,2019,66475,63268,3207
New Mexico,Santa Fe,2019,75116,72153,2963
New Mexico,Sierra,2019,3893,3628,265
New Mexico,Socorro,2019,6446,6071,375
New Mexico,Taos,2019,15218,14303,915
New Mexico,Torrance,2019,5699,5312,387
New Mexico,Union,2019,1846,1781,65
New Mexico,Valencia,2019,30710,29074,1636
New York,Albany,2019,157444,151699,5745
New York,Allegany,2019,19441,18380,1061
New York,Bronx,2019,597677,565642,32035
New York,Broome,2019,83444,79488,3956
New York,Cattaraugus,2019,33884,32172,1712
New York,Cayuga,2019,35952,34411,1541
New York,Chautauqua,2019,54550,51976,2574
New York,Chemung,2019,35019,33543,1476
New York,Chenango,2019,22080,21098,982
New York,Clinton,2019,36302,34720,1582
New York,Columbia,2019,31181,30176,1005
New York,Cortland,2019,22853,21735,1118
New York,Delaware,2019,19117,18216,901
New York,Dutchess,2019,144040,138841,5199
New York,Erie,2019,441291,422508,18783
New York,Essex,2019,16995,16190,805
New York,Franklin,2019,19614,18648,966
New York,Fulton,2019,22656,21517,1139
New York,Genesee,2019,29736,28564,1172
New York,Greene,2019,20271,19358,913
New York,Hamilton,2019,2214,2081,133
New York,Herkimer,2019,27932,26560,1372
New York,Jefferson,2019,43941,41470,2471
New York,Kings,2019,1198160,1149461,48699
New York,Lewis,2019,11644,10999,645
New York,Livingston,2019,30726,29423,1303
New York,Madison,2019,32766,31296,1470
New York,Monroe,2019,361254,346207,15047
New York,Montgomery,2019,22306,21173,1133
New York,Nassau,2019,708118,683726,24392
New York,New York,2019,911638,879665,31973
New York,Niagara,2019,98786,93887,4899
New York,Oneida,2019,101170,96839,4331
New York,Onondaga,2019,220549,211875,8674
New York,Ontario,2019,55362,53210,2152
New York,Orange,2019,184985,177952,7033
New York,Orleans,2019,17567,16740,827
New York,Oswego,2019,52960,50082,2878
New York,Otsego,2019,28060,26876,1184
New York,Putnam,2019,51230,49336,1894
New York,Queens,2019,1139397,1099996,39401
New York,Rensselaer,2019,81089,78030,3059
New York,Richmond,2019,222319,213734,8585
New York,Rockland,2019,155237,149705,5532
New York,Saratoga,2019,118925,114903,4022
New York,Schenectady,2019,76028,73106,2922
New York,Schoharie,2019,14637,13954,683
New York,Schuyler,2019,8085,7709,376
New York,Seneca,2019,16027,15414,613
New York,Steuben,2019,42520,40572,1948
New York,Suffolk,2019,778193,749347,28846
New York,Sullivan,2019,36653,35205,1448
New York,Tioga,2019,22687,21746,941
New York,Tompkins,2019,49361,47567,1794
New York,Ulster,2019,87692,84387,3305
New York,Warren,2019,31299,29868,1431
New York,Washington,2019,27831,26698,1133
New York,Wayne,2019,43835,42070,1765
New York,Westchester,2019,484382,466158,18224
New York,Wyoming,2019,18131,17336,795
New York,Yates,2019,11849,11407,442
North Carolina,Alamance,2019,82597,79459,3138
North Carolina,Alexander,2019,18159,17557,602
North Carolina,Alleghany,2019,4415,4205,210
North Carolina,Anson,2019,10834,10381,453
North Carolina,Ashe,2019,12908,12429,479
North Carolina,Avery,2019,7502,7221,281
North Carolina,Beaufort,2019,19578,18672,906
North Carolina,Bertie,2019,7822,7448,374
North Carolina,Bladen,2019,14629,13923,706
North Carolina,Brunswick,2019,54411,51599,2812
North Carolina,Buncombe,2019,141959,137723,4236
North Carolina,Burke,2019,41324,39785,1539
North Carolina,Cabarrus,2019,109927,106011,3916
North Carolina,Caldwell,2019,36866,35370,1496
North Carolina,Camden,2019,4661,4481,180
North Carolina,Carteret,2019,32229,30889,1340
North Carolina,Caswell,2019,9924,9477,447
North Carolina,Catawba,2019,79540,76686,2854
North Carolina,Chatham,2019,35910,34695,1215
North Carolina,Cherokee,2019,11226,10724,502
North Carolina,Chowan,2019,5560,5298,262
North Carolina,Clay,2019,4148,3960,188
North Carolina,Cleveland,2019,48738,46793,1945
North Carolina,Columbus,2019,22941,21811,1130
North Carolina,Craven,2019,42150,40431,1719
North Carolina,Cumberland,2019,128856,122306,6550
North Carolina,Currituck,2019,14117,13609,508
North Carolina,Dare,2019,20063,19116,947
North Carolina,Davidson,2019,81755,78747,3008
North Carolina,Davie,2019,20873,20161,712
North Carolina,Duplin,2019,25424,24394,1030
North Carolina,Durham,2019,172359,166460,5899
North Carolina,Edgecombe,2019,21439,20179,1260
North Carolina,Forsyth,2019,189793,182709,7084
North Carolina,Franklin,2019,31571,30309,1262
North Carolina,Gaston,2019,111967,107634,4333
North Carolina,Gates,2019,5363,5145,218
North Carolina,Graham,2019,3256,3080,176
North Carolina,Granville,2019,30243,29219,1024
North Carolina,Greene,2019,9577,9215,362
North Carolina,Guilford,2019,265349,254504,10845
North Carolina,Halifax,2019,20501,19326,1175
North Carolina,Harnett,2019,53705,51237,2468
North Carolina,Haywood,2019,30282,29255,1027
North Carolina,Henderson,2019,55704,53865,1839
North Carolina,Hertford,2019,9225,8746,479
North Carolina,Hoke,2019,20307,19304,1003
North Carolina,Hyde,2019,1977,1807,170
North Carolina,Iredell,2019,90208,86966,3242
North Carolina,Jackson,2019,19957,19130,827
North Carolina,Johnston,2019,99974,96347,3627
North Carolina,Jones,2019,4436,4264,172
North Carolina,Lee,2019,26174,24995,1179
North Carolina,Lenoir,2019,28078,27012,1066
North Carolina,Lincoln,2019,43826,42284,1542
North Carolina,Macon,2019,15637,15027,610
North Carolina,Madison,2019,10283,9909,374
North Carolina,Martin,2019,9093,8630,463
North Carolina,McDowell,2019,20877,20075,802
North Carolina,Mecklenburg,2019,626769,603983,22786
North Carolina,Mitchell,2019,6073,5792,281
North Carolina,Montgomery,2019,11606,11143,463
North Carolina,Moore,2019,42887,41263,1624
North Carolina,Nash,2019,43610,41511,2099
North Carolina,New Hanover,2019,125131,120673,4458
North Carolina,Northampton,2019,7792,7386,406
North Carolina,Onslow,2019,65413,62388,3025
North Carolina,Orange,2019,79385,76782,2603
North Carolina,Pamlico,2019,5391,5186,205
North Carolina,Pasquotank,2019,16794,16021,773
North Carolina,Pender,2019,29150,28001,1149
North Carolina,Perquimans,2019,4992,4741,251
North Carolina,Person,2019,18571,17790,781
North Carolina,Pitt,2019,90556,86710,3846
North Carolina,Polk,2019,9094,8748,346
North Carolina,Randolph,2019,66978,64451,2527
North Carolina,Richmond,2019,16727,15844,883
North Carolina,Robeson,2019,50481,47748,2733
North Carolina,Rockingham,2019,40573,38791,1782
North Carolina,Rowan,2019,66751,64079,2672
North Carolina,Rutherford,2019,25376,24131,1245
North Carolina,Sampson,2019,29437,28301,1136
North Carolina,Scotland,2019,11599,10832,767
North Carolina,Stanly,2019,30438,29309,1129
North Carolina,Stokes,2019,21936,21149,787
North Carolina,Surry,2019,34200,32947,1253
North Carolina,Swain,2019,7018,6737,281
North Carolina,Transylvania,2019,14747,14196,551
North Carolina,Tyrrell,2019,1484,1396,88
North Carolina,Union,2019,124843,120533,4310
North Carolina,Vance,2019,17501,16488,1013
North Carolina,Wake,2019,600826,580731,20095
North Carolina,Warren,2019,6638,6260,378
North Carolina,Washington,2019,4492,4229,263
North Carolina,Watauga,2019,29679,28640,1039
North Carolina,Wayne,2019,52394,50225,2169
North Carolina,Wilkes,2019,29489,28292,1197
North Carolina,Wilson,2019,35026,33002,2024
North Carolina,Yadkin,2019,17923,17307,616
North Carolina,Yancey,2019,8466,8148,318
North Dakota,Adams,2019,1046,1023,23
North Dakota,Barnes,2019,5143,4987,156
North Dakota,Benson,2019,2273,2177,96
North Dakota,Billings,2019,430,419,11
North Dakota,Bottineau,2019,2935,2838,97
North Dakota,Bowman,2019,1714,1686,28
North Dakota,Burke,2019,1053,1029,24
North Dakota,Burleigh,2019,49216,48036,1180
North Dakota,Cass,2019,102347,100269,2078
North Dakota,Cavalier,2019,1882,1830,52
North Dakota,Dickey,2019,2281,2238,43
North Dakota,Divide,2019,1439,1419,20
North Dakota,Dunn,2019,3153,3102,51
North Dakota,Eddy,2019,1213,1159,54
North Dakota,Emmons,2019,1428,1369,59
North Dakota,Foster,2019,1497,1456,41
North Dakota,Grand Forks,2019,37105,36332,773
North Dakota,Grant,2019,1179,1152,27
North Dakota,Griggs,2019,1013,988,25
North Dakota,Hettinger,2019,1361,1334,27
North Dakota,Kidder,2019,1247,1197,50
North Dakota,LaMoure,2019,2036,1993,43
North Dakota,Logan,2019,860,840,20
North Dakota,McHenry,2019,3030,2924,106
North Dakota,McIntosh,2019,1104,1071,33
North Dakota,McKenzie,2019,10298,10138,160
North Dakota,McLean,2019,4663,4516,147
North Dakota,Mercer,2019,3577,3427,150
North Dakota,Morton,2019,16191,15713,478
North Dakota,Mountrail,2019,7312,7211,101
North Dakota,Nelson,2019,1373,1330,43
North Dakota,Oliver,2019,861,829,32
North Dakota,Pembina,2019,3303,3189,114
North Dakota,Pierce,2019,1706,1651,55
North Dakota,Ramsey,2019,5551,5388,163
North Dakota,Ransom,2019,2789,2741,48
North Dakota,Renville,2019,1203,1173,30
North Dakota,Richland,2019,8530,8330,200
North Dakota,Rolette,2019,4568,4192,376
North Dakota,Sargent,2019,2634,2587,47
North Dakota,Sheridan,2019,671,642,29
North Dakota,Sioux,2019,1233,1185,48
North Dakota,Slope,2019,393,384,9
North Dakota,Stark,2019,18461,18087,374
North Dakota,Steele,2019,967,947,20
North Dakota,Stutsman,2019,10224,9989,235
North Dakota,Towner,2019,1121,1090,31
North Dakota,Traill,2019,4338,4224,114
North Dakota,Walsh,2019,5109,4942,167
North Dakota,Ward,2019,31394,30614,780
North Dakota,Wells,2019,1890,1832,58
North Dakota,Williams,2019,24427,23989,438
Ohio,Adams,2019,10717,9984,733
Ohio,Allen,2019,47866,45937,1929
Ohio,Ashland,2019,26801,25687,1114
Ohio,Ashtabula,2019,44459,42334,2125
Ohio,Athens,2019,27694,26226,1468
Ohio,Auglaize,2019,24980,24230,750
Ohio,Belmont,2019,30153,28469,1684
Ohio,Brown,2019,19594,18619,975
Ohio,Butler,2019,195091,187729,7362
Ohio,Carroll,2019,12959,12317,642
Ohio,Champaign,2019,20033,19295,738
Ohio,Clark,2019,63253,60520,2733
Ohio,Clermont,2019,106832,102846,3986
Ohio,Clinton,2019,17682,16849,833
Ohio,Columbiana,2019,47395,45105,2290
Ohio,Coshocton,2019,14377,13536,841
Ohio,Crawford,2019,18208,17356,852
Ohio,Cuyahoga,2019,614517,588912,25605
Ohio,Darke,2019,25812,24863,949
Ohio,Defiance,2019,18085,17322,763
Ohio,Delaware,2019,110349,106887,3462
Ohio,Erie,2019,37223,35383,1840
Ohio,Fairfield,2019,78021,75118,2903
Ohio,Fayette,2019,13869,13330,539
Ohio,Franklin,2019,697639,673069,24570
Ohio,Fulton,2019,22455,21526,929
Ohio,Gallia,2019,12158,11496,662
Ohio,Geauga,2019,49294,47586,1708
Ohio,Greene,2019,83246,80130,3116
Ohio,Guernsey,2019,18623,17607,1016
Ohio,Hamilton,2019,416102,400359,15743
Ohio,Hancock,2019,41849,40525,1324
Ohio,Hardin,2019,13812,13232,580
Ohio,Harrison,2019,6800,6443,357
Ohio,Henry,2019,13265,12654,611
Ohio,Highland,2019,17036,16155,881
Ohio,Hocking,2019,13084,12484,600
Ohio,Holmes,2019,20783,20160,623
Ohio,Huron,2019,27985,26381,1604
Ohio,Jackson,2019,12678,11891,787
Ohio,Jefferson,2019,27729,26101,1628
Ohio,Knox,2019,31550,30306,1244
Ohio,Lake,2019,126718,122045,4673
Ohio,Lawrence,2019,23780,22549,1231
Ohio,Licking,2019,90521,87159,3362
Ohio,Logan,2019,22865,22036,829
Ohio,Lorain,2019,154180,147587,6593
Ohio,Lucas,2019,210209,200417,9792
Ohio,Madison,2019,20804,20091,713
Ohio,Mahoning,2019,103081,97180,5901
Ohio,Marion,2019,28444,27292,1152
Ohio,Medina,2019,97857,94520,3337
Ohio,Meigs,2019,9057,8428,629
Ohio,Mercer,2019,23398,22787,611
Ohio,Miami,2019,54117,52125,1992
Ohio,Monroe,2019,5345,4903,442
Ohio,Montgomery,2019,252534,241945,10589
Ohio,Morgan,2019,6714,6280,434
Ohio,Morrow,2019,16815,16124,691
Ohio,Muskingum,2019,39532,37592,1940
Ohio,Noble,2019,4699,4377,322
Ohio,Ottawa,2019,21050,19862,1188
Ohio,Paulding,2019,8628,8297,331
Ohio,Perry,2019,15914,15087,827
Ohio,Pickaway,2019,26460,25404,1056
Ohio,Pike,2019,10824,10155,669
Ohio,Portage,2019,87309,83621,3688
Ohio,Preble,2019,21136,20342,794
Ohio,Putnam,2019,18817,18235,582
Ohio,Richland,2019,52246,49884,2362
Ohio,Ross,2019,35318,33829,1489
Ohio,Sandusky,2019,30506,29193,1313
Ohio,Scioto,2019,28862,27056,1806
Ohio,Seneca,2019,27313,26184,1129
Ohio,Shelby,2019,24178,23325,853
Ohio,Stark,2019,185736,177352,8384
Ohio,Summit,2019,272341,260690,11651
Ohio,Trumbull,2019,86758,81440,5318
Ohio,Tuscarawas,2019,44840,42908,1932
Ohio,Union,2019,28974,28041,933
Ohio,Van Wert,2019,15054,14563,491
Ohio,Vinton,2019,5560,5246,314
Ohio,Warren,2019,119179,115000,4179
Ohio,Washington,2019,27390,25918,1472
Ohio,Wayne,2019,62073,60061,2012
Ohio,Williams,2019,18992,18363,629
Ohio,Wood,2019,71161,68553,2608
Ohio,Wyandot,2019,12975,12569,406
Oklahoma,Adair,2019,8061,7726,335
Oklahoma,Alfalfa,2019,2819,2761,58
Oklahoma,Atoka,2019,4920,4706,214
Oklahoma,Beaver,2019,2876,2819,57
Oklahoma,Beckham,2019,10494,10162,332
Oklahoma,Blaine,2019,4750,4655,95
Oklahoma,Bryan,2019,21334,20684,650
Oklahoma,Caddo,2019,11768,11346,422
Oklahoma,Canadian,2019,74245,72123,2122
Oklahoma,Carter,2019,21512,20772,740
Oklahoma,Cherokee,2019,18737,17989,748
Oklahoma,Choctaw,2019,5428,5166,262
Oklahoma,Cimarron,2019,1324,1301,23
Oklahoma,Cleveland,2019,142822,138776,4046
Oklahoma,Coal,2019,2480,2383,97
Oklahoma,Comanche,2019,48157,46396,1761
Oklahoma,Cotton,2019,2718,2632,86
Oklahoma,Craig,2019,5926,5715,211
Oklahoma,Creek,2019,31636,30465,1171
Oklahoma,Custer,2019,15675,15279,396
Oklahoma,Delaware,2019,17990,17304,686
Oklahoma,Dewey,2019,2891,2829,62
Oklahoma,Ellis,2019,2156,2102,54
Oklahoma,Garfield,2019,27069,26255,814
Oklahoma,Garvin,2019,12576,12174,402
Oklahoma,Grady,2019,26474,25657,817
Oklahoma,Grant,2019,2650,2594,56
Oklahoma,Greer,2019,1836,1758,78
Oklahoma,Harmon,2019,1174,1140,34
Oklahoma,Harper,2019,1748,1697,51
Oklahoma,Haskell,2019,4217,3994,223
Oklahoma,Hughes,2019,5316,5057,259
Oklahoma,Jackson,2019,10650,10337,313
Oklahoma,Jefferson,2019,2506,2425,81
Oklahoma,Johnston,2019,3755,3593,162
Oklahoma,Kay,2019,18307,17526,781
Oklahoma,Kingfisher,2019,9142,8955,187
Oklahoma,Kiowa,2019,3453,3323,130
Oklahoma,Latimer,2019,3135,2937,198
Oklahoma,Le Flore,2019,19035,18141,894
Oklahoma,Lincoln,2019,15776,15219,557
Oklahoma,Logan,2019,22081,21445,636
Oklahoma,Love,2019,6170,6030,140
Oklahoma,Major,2019,3871,3788,83
Oklahoma,Marshall,2019,6880,6642,238
Oklahoma,Mayes,2019,19411,18802,609
Oklahoma,McClain,2019,19628,19092,536
Oklahoma,McCurtain,2019,14383,13570,813
Oklahoma,McIntosh,2019,7067,6654,413
Oklahoma,Murray,2019,6307,6117,190
Oklahoma,Muskogee,2019,29568,28418,1150
Oklahoma,Noble,2019,5669,5530,139
Oklahoma,Nowata,2019,4593,4434,159
Oklahoma,Okfuskee,2019,4614,4402,212
Oklahoma,Oklahoma,2019,384731,372632,12099
Oklahoma,Okmulgee,2019,15712,14943,769
Oklahoma,Osage,2019,20704,19921,783
Oklahoma,Ottawa,2019,14077,13599,478
Oklahoma,Pawnee,2019,7363,7074,289
Oklahoma,Payne,2019,37930,36836,1094
Oklahoma,Pittsburg,2019,17129,16406,723
Oklahoma,Pontotoc,2019,19044,18451,593
Oklahoma,Pottawatomie,2019,32342,31169,1173
Oklahoma,Pushmataha,2019,4278,4066,212
Oklahoma,Roger Mills,2019,1878,1822,56
Oklahoma,Rogers,2019,45151,43759,1392
Oklahoma,Seminole,2019,9434,8979,455
Oklahoma,Sequoyah,2019,16168,15502,666
Oklahoma,Stephens,2019,18536,17737,799
Oklahoma,Texas,2019,11189,10969,220
Oklahoma,Tillman,2019,2989,2879,110
Oklahoma,Tulsa,2019,323670,313397,10273
Oklahoma,Wagoner,2019,37999,36806,1193
Oklahoma,Washington,2019,22310,21547,763
Oklahoma,Washita,2019,5203,5028,175
Oklahoma,Woods,2019,4601,4505,96
Oklahoma,Woodward,2019,8988,8727,261
Oregon,Baker,2019,7120,6789,331
Oregon,Benton,2019,48151,46736,1415
Oregon,Clackamas,2019,219468,212043,7425
Oregon,Clatsop,2019,19385,18659,726
Oregon,Columbia,2019,24437,23340,1097
Oregon,Coos,2019,26147,24874,1273
Oregon,Crook,2019,9593,9083,510
Oregon,Curry,2019,8895,8432,463
Oregon,Deschutes,2019,96093,92361,3732
Oregon,Douglas,2019,46339,44063,2276
Oregon,Gilliam,2019,947,912,35
Oregon,Grant,2019,3185,2964,221
Oregon,Harney,2019,3577,3387,190
Oregon,Hood River,2019,14470,14012,458
Oregon,Jackson,2019,103451,98950,4501
Oregon,Jefferson,2019,10125,9613,512
Oregon,Josephine,2019,35786,34004,1782
Oregon,Klamath,2019,29291,27485,1806
Oregon,Lake,2019,3628,3433,195
Oregon,Lane,2019,180588,173271,7317
Oregon,Lincoln,2019,20848,19947,901
Oregon,Linn,2019,58720,56191,2529
Oregon,Malheur,2019,12314,11804,510
Oregon,Marion,2019,161879,155513,6366
Oregon,Morrow,2019,5712,5477,235
Oregon,Multnomah,2019,455189,440311,14878
Oregon,Polk,2019,39860,38240,1620
Oregon,Sherman,2019,932,900,32
Oregon,Tillamook,2019,11879,11421,458
Oregon,Umatilla,2019,36779,35014,1765
Oregon,Union,2019,11938,11362,576
Oregon,Wallowa,2019,3420,3221,199
Oregon,Wasco,2019,13360,12809,551
Oregon,Washington,2019,325006,315008,9998
Oregon,Wheeler,2019,722,691,31
Oregon,Yamhill,2019,54839,52981,1858
Pennsylvania,Adams,2019,55350,53531,1819
Pennsylvania,Allegheny,2019,649873,623045,26828
Pennsylvania,Armstrong,2019,32307,30671,1636
Pennsylvania,Beaver,2019,84172,80367,3805
Pennsylvania,Bedford,2019,23622,22510,1112
Pennsylvania,Berks,2019,216147,206763,9384
Pennsylvania,Blair,2019,59551,56860,2691
Pennsylvania,Bradford,2019,28959,27697,1262
Pennsylvania,Bucks,2019,345279,332053,13226
Pennsylvania,Butler,2019,99994,96090,3904
Pennsylvania,Cambria,2019,58064,54963,3101
Pennsylvania,Cameron,2019,2088,1963,125
Pennsylvania,Carbon,2019,32252,30516,1736
Pennsylvania,Centre,2019,80144,77464,2680
Pennsylvania,Chester,2019,286480,277341,9139
Pennsylvania,Clarion,2019,17131,16289,842
Pennsylvania,Clearfield,2019,35987,34114,1873
Pennsylvania,Clinton,2019,18338,17347,991
Pennsylvania,Columbia,2019,33552,31955,1597
Pennsylvania,Crawford,2019,38685,36853,1832
Pennsylvania,Cumberland,2019,132626,128165,4461
Pennsylvania,Dauphin,2019,144836,139003,5833
Pennsylvania,Delaware,2019,299802,287670,12132
Pennsylvania,Elk,2019,15677,14911,766
Pennsylvania,Erie,2019,128841,122943,5898
Pennsylvania,Fayette,2019,57273,53868,3405
Pennsylvania,Forest,2019,1818,1694,124
Pennsylvania,Franklin,2019,77887,74904,2983
Pennsylvania,Fulton,2019,7907,7560,347
Pennsylvania,Greene,2019,16626,15771,855
Pennsylvania,Huntingdon,2019,20012,18833,1179
Pennsylvania,Indiana,2019,39155,37186,1969
Pennsylvania,Jefferson,2019,20587,19612,975
Pennsylvania,Juniata,2019,12616,12061,555
Pennsylvania,Lackawanna,2019,105216,100057,5159
Pennsylvania,Lancaster,2019,285253,275432,9821
Pennsylvania,Lawrence,2019,40775,38687,2088
Pennsylvania,Lebanon,2019,72617,69798,2819
Pennsylvania,Lehigh,2019,193388,184665,8723
Pennsylvania,Luzerne,2019,157695,148722,8973
Pennsylvania,Lycoming,2019,56919,54169,2750
Pennsylvania,McKean,2019,17355,16435,920
Pennsylvania,Mercer,2019,49321,46909,2412
Pennsylvania,Mifflin,2019,21076,20093,983
Pennsylvania,Monroe,2019,83291,78812,4479
Pennsylvania,Montgomery,2019,456383,440364,16019
Pennsylvania,Montour,2019,9122,8795,327
Pennsylvania,Northampton,2019,161856,154642,7214
Pennsylvania,Northumberland,2019,43184,40765,2419
Pennsylvania,Perry,2019,24583,23673,910
Pennsylvania,Philadelphia,2019,722078,682012,40066
Pennsylvania,Pike,2019,25321,23909,1412
Pennsylvania,Potter,2019,7209,6784,425
Pennsylvania,Schuylkill,2019,66554,62948,3606
Pennsylvania,Snyder,2019,20172,19079,1093
Pennsylvania,Somerset,2019,33659,31869,1790
Pennsylvania,Sullivan,2019,2671,2531,140
Pennsylvania,Susquehanna,2019,20606,19717,889
Pennsylvania,Tioga,2019,19148,18139,1009
Pennsylvania,Union,2019,19912,19114,798
Pennsylvania,Venango,2019,22444,21354,1090
Pennsylvania,Warren,2019,18977,18116,861
Pennsylvania,Washington,2019,107299,102475,4824
Pennsylvania,Wayne,2019,22486,21427,1059
Pennsylvania,Westmoreland,2019,181453,173320,8133
Pennsylvania,Wyoming,2019,13610,12948,662
Pennsylvania,York,2019,236377,227297,9080
Rhode Island,Bristol,2019,26005,25226,779
Rhode Island,Kent,2019,90729,87815,2914
Rhode Island,Newport,2019,44280,42905,1375
Rhode Island,Providence,2019,325490,312930,12560
Rhode Island,Washington,2019,69050,66892,2158
South Carolina,Abbeville,2019,10050,9711,339
South Carolina,Aiken,2019,75105,72929,2176
South Carolina,Allendale,2019,2692,2549,143
South Carolina,Anderson,2019,91576,89109,2467
South Carolina,Bamberg,2019,4981,4704,277
South Carolina,Barnwell,2019,8268,7916,352
South Carolina,Beaufort,2019,77858,75797,2061
South Carolina,Berkeley,2019,104452,101801,2651
South Carolina,Calhoun,2019,6604,6367,237
South Carolina,Charleston,2019,212354,207473,4881
South Carolina,Cherokee,2019,25196,24422,774
South Carolina,Chester,2019,13445,12890,555
South Carolina,Chesterfield,2019,22128,21484,644
South Carolina,Clarendon,2019,12731,12238,493
South Carolina,Colleton,2019,16821,16283,538
South Carolina,Darlington,2019,30561,29518,1043
South Carolina,Dillon,2019,13029,12496,533
South Carolina,Dorchester,2019,78453,76502,1951
South Carolina,Edgefield,2019,10753,10452,301
South Carolina,Fairfield,2019,9619,9192,427
South Carolina,Florence,2019,67211,65235,1976
South Carolina,Georgetown,2019,25790,24820,970
South Carolina,Greenville,2019,255903,249678,6225
South Carolina,Greenwood,2019,31377,30397,980
South Carolina,Hampton,2019,8416,8187,229
South Carolina,Horry,2019,148573,143234,5339
South Carolina,Jasper,2019,12685,12363,322
South Carolina,Kershaw,2019,29291,28425,866
South Carolina,Lancaster,2019,41340,39956,1384
South Carolina,Laurens,2019,30313,29410,903
South Carolina,Lee,2019,6618,6352,266
South Carolina,Lexington,2019,150160,146650,3510
South Carolina,Marion,2019,13045,12481,564
South Carolina,Marlboro,2019,9183,8739,444
South Carolina,McCormick,2019,3389,3285,104
South Carolina,Newberry,2019,19223,18709,514
South Carolina,Oconee,2019,35039,34068,971
South Carolina,Orangeburg,2019,34842,33187,1655
South Carolina,Pickens,2019,57667,56063,1604
South Carolina,Richland,2019,198948,193369,5579
South Carolina,Saluda,2019,8928,8690,238
South Carolina,Spartanburg,2019,153496,149576,3920
South Carolina,Sumter,2019,43727,42254,1473
South Carolina,Union,2019,11681,11275,406
South Carolina,Williamsburg,2019,12093,11542,551
South Carolina,York,2019,140458,136587,3871
South Dakota,Aurora,2019,1527,1485,42
South Dakota,Beadle,2019,9618,9315,303
South Dakota,Bennett,2019,1091,1032,59
South Dakota,Bon Homme,2019,2870,2779,91
South Dakota,Brookings,2019,19138,18511,627
South Dakota,Brown,2019,20795,20152,643
South Dakota,Brule,2019,2451,2375,76
South Dakota,Buffalo,2019,683,638,45
South Dakota,Butte,2019,5044,4873,171
South Dakota,Campbell,2019,772,744,28
South Dakota,Charles Mix,2019,3763,3622,141
South Dakota,Clark,2019,1913,1836,77
South Dakota,Clay,2019,7432,7184,248
South Dakota,Codington,2019,15518,15028,490
South Dakota,Corson,2019,1368,1289,79
South Dakota,Custer,2019,4009,3831,178
South Dakota,Davison,2019,11103,10778,325
South Dakota,Day,2019,2763,2637,126
South Dakota,Deuel,2019,2172,2067,105
South Dakota,Dewey,2019,2228,2044,184
South Dakota,Douglas,2019,1584,1539,45
South Dakota,Edmunds,2019,2041,1980,61
South Dakota,Fall River,2019,2992,2864,128
South Dakota,Faulk,2019,1058,1023,35
South Dakota,Grant,2019,4443,4293,150
South Dakota,Gregory,2019,2048,1977,71
South Dakota,Haakon,2019,1051,1020,31
South Dakota,Hamlin,2019,3319,3210,109
South Dakota,Hand,2019,1783,1733,50
South Dakota,Hanson,2019,1745,1663,82
South Dakota,Harding,2019,725,705,20
South Dakota,Hughes,2019,10039,9771,268
South Dakota,Hutchinson,2019,3598,3486,112
South Dakota,Hyde,2019,682,658,24
South Dakota,Jackson,2019,1272,1199,73
South Dakota,Jerauld,2019,1117,1086,31
South Dakota,Jones,2019,544,527,17
South Dakota,Kingsbury,2019,2671,2590,81
South Dakota,Lake,2019,6684,6443,241
South Dakota,Lawrence,2019,13343,12915,428
South Dakota,Lincoln,2019,34595,33709,886
South Dakota,Lyman,2019,1690,1609,81
South Dakota,Marshall,2019,2383,2292,91
South Dakota,McCook,2019,3078,2990,88
South Dakota,McPherson,2019,1006,963,43
South Dakota,Meade,2019,14138,13632,506
South Dakota,Mellette,2019,741,699,42
South Dakota,Miner,2019,1177,1140,37
South Dakota,Minnehaha,2019,113094,109853,3241
South Dakota,Moody,2019,4041,3895,146
South Dakota,Pennington,2019,56757,54827,1930
South Dakota,Perkins,2019,1425,1381,44
South Dakota,Potter,2019,1045,1012,33
South Dakota,Roberts,2019,4839,4630,209
South Dakota,Sanborn,2019,1153,1117,36
South Dakota,Spink,2019,3189,3080,109
South Dakota,Stanley,2019,1850,1795,55
South Dakota,Sully,2019,800,777,23
South Dakota,Todd,2019,3166,2961,205
South Dakota,Tripp,2019,3070,2981,89
South Dakota,Turner,2019,4702,4559,143
South Dakota,Union,2019,8484,8192,292
South Dakota,Walworth,2019,2125,2008,117
South Dakota,Yankton,2019,11958,11615,343
South Dakota,Ziebach,2019,930,878,52
Tennessee,Anderson,2019,34949,33708,1241
Tennessee,Bedford,2019,21223,20437,786
Tennessee,Benton,2019,6964,6653,311
Tennessee,Bledsoe,2019,4346,4111,235
Tennessee,Blount,2019,64115,62072,2043
Tennessee,Bradley,2019,52465,50654,1811
Tennessee,Campbell,2019,14978,14291,687
Tennessee,Cannon,2019,6686,6481,205
Tennessee,Carroll,2019,12172,11582,590
Tennessee,Carter,2019,24218,23235,983
Tennessee,Cheatham,2019,22186,21606,580
Tennessee,Chester,2019,8640,8343,297
Tennessee,Claiborne,2019,13178,12624,554
Tennessee,Clay,2019,2808,2640,168
Tennessee,Cocke,2019,15164,14477,687
Tennessee,Coffee,2019,25749,24891,858
Tennessee,Crockett,2019,7069,6823,246
Tennessee,Cumberland,2019,23685,22624,1061
Tennessee,Davidson,2019,409810,399502,10308
Tennessee,Decatur,2019,4611,4366,245
Tennessee,DeKalb,2019,7855,7516,339
Tennessee,Dickson,2019,27409,26593,816
Tennessee,Dyer,2019,16597,15792,805
Tennessee,Fayette,2019,19370,18663,707
Tennessee,Fentress,2019,7555,7240,315
Tennessee,Franklin,2019,20343,19663,680
Tennessee,Gibson,2019,22262,21320,942
Tennessee,Giles,2019,15126,14543,583
Tennessee,Grainger,2019,9608,9221,387
Tennessee,Greene,2019,29995,28599,1396
Tennessee,Grundy,2019,5017,4809,208
Tennessee,Hamblen,2019,28385,27292,1093
Tennessee,Hamilton,2019,185402,179393,6009
Tennessee,Hancock,2019,2130,2005,125
Tennessee,Hardeman,2019,9576,9099,477
Tennessee,Hardin,2019,10486,10038,448
Tennessee,Hawkins,2019,23986,22998,988
Tennessee,Haywood,2019,7749,7373,376
Tennessee,Henderson,2019,12369,11832,537
Tennessee,Henry,2019,14321,13727,594
Tennessee,Hickman,2019,11599,11243,356
Tennessee,Houston,2019,3297,3146,151
Tennessee,Humphreys,2019,9025,8678,347
Tennessee,Jackson,2019,4702,4486,216
Tennessee,Jefferson,2019,24800,23882,918
Tennessee,Johnson,2019,7730,7462,268
Tennessee,Knox,2019,246227,239090,7137
Tennessee,Lake,2019,1779,1678,101
Tennessee,Lauderdale,2019,9794,9262,532
Tennessee,Lawrence,2019,19432,18640,792
Tennessee,Lewis,2019,5221,5010,211
Tennessee,Lincoln,2019,16900,16295,605
Tennessee,Loudon,2019,23696,22895,801
Tennessee,Macon,2019,11435,11079,356
Tennessee,Madison,2019,49493,47727,1766
Tennessee,Marion,2019,12598,12057,541
Tennessee,Marshall,2019,15860,15305,555
Tennessee,Maury,2019,50157,48575,1582
Tennessee,McMinn,2019,23880,22978,902
Tennessee,McNairy,2019,8580,8130,450
Tennessee,Meigs,2019,5230,4992,238
Tennessee,Monroe,2019,20356,19613,743
Tennessee,Montgomery,2019,86220,82946,3274
Tennessee,Moore,2019,3635,3529,106
Tennessee,Morgan,2019,7956,7632,324
Tennessee,Obion,2019,12615,11999,616
Tennessee,Overton,2019,10026,9647,379
Tennessee,Perry,2019,3146,2988,158
Tennessee,Pickett,2019,2385,2274,111
Tennessee,Polk,2019,7576,7274,302
Tennessee,Putnam,2019,35355,34124,1231
Tennessee,Rhea,2019,13401,12636,765
Tennessee,Roane,2019,23617,22662,955
Tennessee,Robertson,2019,38549,37440,1109
Tennessee,Rutherford,2019,186696,181904,4792
Tennessee,Scott,2019,8427,8059,368
Tennessee,Sequatchie,2019,6250,5987,263
Tennessee,Sevier,2019,55225,53420,1805
Tennessee,Shelby,2019,449965,431885,18080
Tennessee,Smith,2019,9589,9301,288
Tennessee,Stewart,2019,5540,5292,248
Tennessee,Sullivan,2019,70979,68347,2632
Tennessee,Sumner,2019,103810,101033,2777
Tennessee,Tipton,2019,28461,27356,1105
Tennessee,Trousdale,2019,5503,5335,168
Tennessee,Unicoi,2019,7167,6809,358
Tennessee,Union,2019,7698,7387,311
Tennessee,Van Buren,2019,2072,1979,93
Tennessee,Warren,2019,16869,16178,691
Tennessee,Washington,2019,60904,58800,2104
Tennessee,Wayne,2019,6301,6007,294
Tennessee,Weakley,2019,16267,15610,657
Tennessee,White,2019,12363,11908,455
Tennessee,Williamson,2019,130215,127057,3158
Tennessee,Wilson,2019,77728,75639,2089
Texas,Anderson,2019,23913,23220,693
Texas,Andrews,2019,9906,9685,221
Texas,Angelina,2019,35893,34453,1440
Texas,Aransas,2019,9425,9022,403
Texas,Archer,2019,4145,4027,118
Texas,Armstrong,2019,929,904,25
Texas,Atascosa,2019,21707,20928,779
Texas,Austin,2019,14096,13613,483
Texas,Bailey,2019,2508,2415,93
Texas,Bandera,2019,10071,9742,329
Texas,Bastrop,2019,42900,41609,1291
Texas,Baylor,2019,1765,1725,40
Texas,Bee,2019,9853,9419,434
Texas,Bell,2019,143858,138392,5466
Texas,Bexar,2019,949380,919763,29617
Texas,Blanco,2019,6469,6311,158
Texas,Borden,2019,404,394,10
Texas,Bosque,2019,8343,8058,285
Texas,Bowie,2019,39899,38130,1769
Texas,Brazoria,2019,179539,172008,7531
Texas,Brazos,2019,119010,115819,3191
Texas,Brewster,2019,4207,4084,123
Texas,Briscoe,2019,578,558,20
Texas,Brooks,2019,2602,2468,134
Texas,Brown,2019,15701,15117,584
Texas,Burleson,2019,8362,8103,259
Texas,Burnet,2019,23570,22930,640
Texas,Caldwell,2019,19669,19011,658
Texas,Calhoun,2019,12168,11776,392
Texas,Callahan,2019,6113,5925,188
Texas,Cameron,2019,166861,157675,9186
Texas,Camp,2019,4975,4766,209
Texas,Carson,2019,3011,2933,78
Texas,Cass,2019,12430,11895,535
Texas,Castro,2019,3433,3337,96
Texas,Chambers,2019,19489,18604,885
Texas,Cherokee,2019,20936,20143,793
Texas,Childress,2019,2952,2872,80
Texas,Clay,2019,4936,4785,151
Texas,Cochran,2019,1123,1085,38
Texas,Coke,2019,1456,1409,47
Texas,Coleman,2019,2888,2770,118
Texas,Collin,2019,563678,546320,17358
Texas,Collingsworth,2019,1157,1120,37
Texas,Colorado,2019,9860,9557,303
Texas,Comal,2019,73333,71149,2184
Texas,Comanche,2019,5591,5410,181
Texas,Concho,2019,1238,1198,40
Texas,Cooke,2019,19820,19268,552
Texas,Coryell,2019,24123,23177,946
Texas,Cottle,2019,551,528,23
Texas,Crane,2019,1569,1506,63
Texas,Crockett,2019,1637,1589,48
Texas,Crosby,2019,2499,2402,97
Texas,Culberson,2019,1044,1002,42
Texas,Dallam,2019,3918,3842,76
Texas,Dallas,2019,1364652,1317507,47145
Texas,Dawson,2019,4642,4462,180
Texas,Deaf Smith,2019,8470,8237,233
Texas,Delta,2019,2443,2360,83
Texas,Denton,2019,494624,480005,14619
Texas,DeWitt,2019,9798,9540,258
Texas,Dickens,2019,682,652,30
Texas,Dimmit,2019,7487,7298,189
Texas,Donley,2019,1439,1389,50
Texas,Duval,2019,4966,4744,222
Texas,Eastland,2019,8354,8079,275
Texas,Ector,2019,88186,85859,2327
Texas,Edwards,2019,1054,1030,24
Texas,El Paso,2019,362582,348712,13870
Texas,Ellis,2019,92694,89823,2871
Texas,Erath,2019,20850,20188,662
Texas,Falls,2019,6570,6356,214
Texas,Fannin,2019,17329,16854,475
Texas,Fayette,2019,12313,11987,326
Texas,Fisher,2019,1634,1586,48
Texas,Floyd,2019,2580,2468,112
Texas,Foard,2019,585,567,18
Texas,Fort Bend,2019,392275,378653,13622
Texas,Franklin,2019,4654,4485,169
Texas,Freestone,2019,6400,6093,307
Texas,Frio,2019,10463,10192,271
Texas,Gaines,2019,9812,9577,235
Texas,Galveston,2019,165479,158807,6672
Texas,Garza,2019,2176,2117,59
Texas,Gillespie,2019,13542,13213,329
Texas,Glasscock,2019,795,778,17
Texas,Goliad,2019,3272,3162,110
Texas,Gonzales,2019,9578,9320,258
Texas,Gray,2019,8080,7791,289
Texas,Grayson,2019,64106,62148,1958
Texas,Gregg,2019,58349,56176,2173
Texas,Grimes,2019,11264,10822,442
Texas,Guadalupe,2019,81486,79087,2399
Texas,Hale,2019,12210,11663,547
Texas,Hall,2019,1073,1029,44
Texas,Hamilton,2019,3672,3561,111
Texas,Hansford,2019,2779,2714,65
Texas,Hardeman,2019,1722,1670,52
Texas,Hardin,2019,25321,24158,1163
Texas,Harris,2019,2317346,2228703,88643
Texas,Harrison,2019,29485,28306,1179
Texas,Hartley,2019,2802,2756,46
Texas,Haskell,2019,2285,2210,75
Texas,Hays,2019,119874,116574,3300
Texas,Hemphill,2019,1937,1884,53
Texas,Henderson,2019,36518,35239,1279
Texas,Hidalgo,2019,352815,330817,21998
Texas,Hill,2019,16409,15867,542
Texas,Hockley,2019,11290,10956,334
Texas,Hood,2019,27560,26625,935
Texas,Hopkins,2019,17544,17008,536
Texas,Houston,2019,10364,10039,325
Texas,Howard,2019,14040,13604,436
Texas,Hudspeth,2019,1827,1747,80
Texas,Hunt,2019,43412,41871,1541
Texas,Hutchinson,2019,8701,8315,386
Texas,Irion,2019,761,743,18
Texas,Jack,2019,3471,3362,109
Texas,Jackson,2019,7588,7360,228
Texas,Jasper,2019,12869,12083,786
Texas,Jeff Davis,2019,1040,1010,30
Texas,Jefferson,2019,106962,100737,6225
Texas,Jim Hogg,2019,1884,1794,90
Texas,Jim Wells,2019,16852,16054,798
Texas,Johnson,2019,82176,79532,2644
Texas,Jones,2019,5738,5494,244
Texas,Karnes,2019,7187,7008,179
Texas,Kaufman,2019,64597,62485,2112
Texas,Kendall,2019,22132,21533,599
Texas,Kenedy,2019,223,215,8
Texas,Kent,2019,478,467,11
Texas,Kerr,2019,22251,21593,658
Texas,Kimble,2019,1862,1805,57
Texas,King,2019,233,228,5
Texas,Kinney,2019,1377,1327,50
Texas,Kleberg,2019,13496,12908,588
Texas,Knox,2019,1444,1397,47
Texas,La Salle,2019,4401,4295,106
Texas,Lamar,2019,24052,23241,811
Texas,Lamb,2019,5311,5108,203
Texas,Lampasas,2019,9212,8910,302
Texas,Lavaca,2019,8590,8333,257
Texas,Lee,2019,10120,9852,268
Texas,Leon,2019,6325,6049,276
Texas,Liberty,2019,33101,31432,1669
Texas,Limestone,2019,8593,8260,333
Texas,Lipscomb,2019,1650,1607,43
Texas,Live Oak,2019,5564,5392,172
Texas,Llano,2019,8679,8380,299
Texas,Loving,2019,542,538,4
Texas,Lubbock,2019,158134,153680,4454
Texas,Lynn,2019,2775,2693,82
Texas,Madison,2019,4555,4361,194
Texas,Marion,2019,4239,4058,181
Texas,Martin,2019,2889,2814,75
Texas,Mason,2019,1772,1715,57
Texas,Matagorda,2019,16712,15766,946
Texas,Maverick,2019,23803,22013,1790
Texas,McCulloch,2019,3488,3307,181
Texas,McLennan,2019,119629,115668,3961
Texas,McMullen,2019,821,808,13
Texas,Medina,2019,21828,21142,686
Texas,Menard,2019,862,832,30
Texas,Midland,2019,107495,105290,2205
Texas,Milam,2019,9788,9301,487
Texas,Mills,2019,1904,1842,62
Texas,Mitchell,2019,2325,2243,82
Texas,Montague,2019,9323,9058,265
Texas,Montgomery,2019,284078,274419,9659
Texas,Moore,2019,10915,10660,255
Texas,Morris,2019,4808,4552,256
Texas,Motley,2019,483,466,17
Texas,Nacogdoches,2019,28210,27153,1057
Texas,Navarro,2019,24061,23283,778
Texas,Newton,2019,5182,4858,324
Texas,Nolan,2019,7066,6860,206
Texas,Nueces,2019,167411,160536,6875
Texas,Ochiltree,2019,4330,4213,117
Texas,Oldham,2019,916,890,26
Texas,Orange,2019,36395,34518,1877
Texas,Palo Pinto,2019,13602,13175,427
Texas,Panola,2019,10208,9799,409
Texas,Parker,2019,67332,65373,1959
Texas,Parmer,2019,4897,4787,110
Texas,Pecos,2019,6397,6188,209
Texas,Polk,2019,18023,17171,852
Texas,Potter,2019,55183,53668,1515
Texas,Presidio,2019,3104,2902,202
Texas,Rains,2019,6044,5862,182
Texas,Randall,2019,72066,70315,1751
Texas,Reagan,2019,1909,1861,48
Texas,Real,2019,1062,1020,42
Texas,Red River,2019,5108,4873,235
Texas,Reeves,2019,11403,11209,194
Texas,Refugio,2019,3154,3036,118
Texas,Roberts,2019,418,405,13
Texas,Robertson,2019,7656,7383,273
Texas,Rockwall,2019,52083,50482,1601
Texas,Runnels,2019,4604,4475,129
Texas,Rusk,2019,23074,22251,823
Texas,Sabine,2019,3737,3490,247
Texas,San Augustine,2019,3402,3240,162
Texas,San Jacinto,2019,11749,11211,538
Texas,San Patricio,2019,29906,28278,1628
Texas,San Saba,2019,2569,2494,75
Texas,Schleicher,2019,1323,1285,38
Texas,Scurry,2019,6736,6518,218
Texas,Shackelford,2019,1910,1868,42
Texas,Shelby,2019,11178,10738,440
Texas,Sherman,2019,1379,1347,32
Texas,Smith,2019,107171,103584,3587
Texas,Somervell,2019,4364,4209,155
Texas,Starr,2019,25227,22745,2482
Texas,Stephens,2019,4109,3983,126
Texas,Sterling,2019,579,561,18
Texas,Stonewall,2019,588,571,17
Texas,Sutton,2019,1414,1361,53
Texas,Swisher,2019,2628,2531,97
Texas,Tarrant,2019,1082571,1046916,35655
Texas,Taylor,2019,66926,65005,1921
Texas,Terrell,2019,377,364,13
Texas,Terry,2019,5006,4823,183
Texas,Throckmorton,2019,656,631,25
Texas,Titus,2019,12976,12435,541
Texas,Tom Green,2019,54568,52917,1651
Texas,Travis,2019,741101,722054,19047
Texas,Trinity,2019,5317,5064,253
Texas,Tyler,2019,7156,6744,412
Texas,Upshur,2019,17914,17251,663
Texas,Upton,2019,1675,1626,49
Texas,Uvalde,2019,11501,11065,436
Texas,Val Verde,2019,22932,22162,770
Texas,Van Zandt,2019,26082,25233,849
Texas,Victoria,2019,42854,41380,1474
Texas,Walker,2019,24150,23214,936
Texas,Waller,2019,23475,22597,878
Texas,Ward,2019,7488,7316,172
Texas,Washington,2019,15155,14656,499
Texas,Webb,2019,118626,114247,4379
Texas,Wharton,2019,21670,20935,735
Texas,Wheeler,2019,2279,2210,69
Texas,Wichita,2019,56362,54574,1788
Texas,Wilbarger,2019,4975,4798,177
Texas,Willacy,2019,6592,6052,540
Texas,Williamson,2019,313899,305127,8772
Texas,Wilson,2019,24876,24174,702
Texas,Winkler,2019,4026,3913,113
Texas,Wise,2019,31891,30864,1027
Texas,Wood,2019,17693,17008,685
Texas,Yoakum,2019,3750,3641,109
Texas,Young,2019,8040,7802,238
Texas,Zapata,2019,5045,4787,258
Texas,Zavala,2019,3334,3050,284
Utah,Beaver,2019,2869,2783,86
Utah,Box Elder,2019,25904,25222,682
Utah,Cache,2019,64176,62779,1397
Utah,Carbon,2019,8517,8202,315
Utah,Daggett,2019,393,378,15
Utah,Davis,2019,173800,169589,4211
Utah,Duchesne,2019,7762,7457,305
Utah,Emery,2019,4312,4139,173
Utah,Garfield,2019,2784,2611,173
Utah,Grand,2019,6195,5953,242
Utah,Iron,2019,24030,23326,704
Utah,Juab,2019,5720,5576,144
Utah,Kane,2019,3818,3707,111
Utah,Millard,2019,5997,5832,165
Utah,Morgan,2019,5563,5428,135
Utah,Piute,2019,482,459,23
Utah,Rich,2019,1172,1136,36
Utah,San Juan,2019,5725,5435,290
Utah,Sanpete,2019,12479,12081,398
Utah,Sevier,2019,9741,9438,303
Utah,Summit,2019,25039,24427,612
Utah,Tooele,2019,34002,33024,978
Utah,Uintah,2019,13671,13096,575
Utah,Utah,2019,307609,300283,7326
Utah,Wasatch,2019,16141,15705,436
Utah,Washington,2019,76056,73806,2250
Utah,Wayne,2019,1417,1339,78
Utah,Weber,2019,127579,123806,3773
Vermont,Addison,2019,20566,20091,475
Vermont,Bennington,2019,18070,17539,531
Vermont,Caledonia,2019,14460,14030,430
Vermont,Chittenden,2019,96435,94707,1728
Vermont,Essex,2019,2682,2595,87
Vermont,Franklin,2019,27313,26674,639
Vermont,Grand Isle,2019,4041,3925,116
Vermont,Lamoille,2019,13888,13454,434
Vermont,Orange,2019,15905,15527,378
Vermont,Orleans,2019,13275,12713,562
Vermont,Rutland,2019,30446,29608,838
Vermont,Washington,2019,34360,33586,774
Vermont,Windham,2019,21977,21416,561
Vermont,Windsor,2019,28809,28205,604
Virginia,Accomack,2019,16708,16117,591
Virginia,Albemarle,2019,57688,56256,1432
Virginia,Alexandria city,2019,102254,100093,2161
Virginia,Alleghany,2019,6915,6677,238
Virginia,Amelia,2019,6323,6123,200
Virginia,Amherst,2019,15136,14651,485
Virginia,Appomattox,2019,7209,6959,250
Virginia,Arlington,2019,155769,152803,2966
Virginia,Augusta,2019,37722,36806,916
Virginia,Bath,2019,2509,2447,62
Virginia,Bedford,2019,38712,37606,1106
Virginia,Bland,2019,2856,2777,79
Virginia,Botetourt,2019,17494,17049,445
Virginia,Bristol city,2019,7218,6946,272
Virginia,Brunswick,2019,6066,5781,285
Virginia,Buchanan,2019,6739,6359,380
Virginia,Buckingham,2019,6475,6206,269
Virginia,Buena Vista city,2019,3436,3342,94
Virginia,Campbell,2019,26165,25349,816
Virginia,Caroline,2019,15369,14879,490
Virginia,Carroll,2019,13292,12818,474
Virginia,Charles City,2019,3692,3566,126
Virginia,Charlotte,2019,5297,5109,188
Virginia,Charlottesville city,2019,26642,26011,631
Virginia,Chesapeake city,2019,123523,119957,3566
Virginia,Chesterfield,2019,189000,183821,5179
Virginia,Clarke,2019,7665,7476,189
Virginia,Colonial Heights city,2019,8877,8593,284
Virginia,Covington city,2019,2393,2293,100
Virginia,Craig,2019,2312,2238,74
Virginia,Culpeper,2019,24818,24175,643
Virginia,Cumberland,2019,4664,4523,141
Virginia,Danville city,2019,19226,18261,965
Virginia,Dickenson,2019,4731,4497,234
Virginia,Dinwiddie,2019,13769,13319,450
Virginia,Emporia city,2019,2303,2189,114
Virginia,Essex,2019,5526,5330,196
Virginia,Fairfax,2019,641034,626394,14640
Virginia,Fairfax city,2019,13573,13284,289
Virginia,Falls Church city,2019,8676,8499,177
Virginia,Fauquier,2019,37567,36655,912
Virginia,Floyd,2019,8227,8014,213
Virginia,Fluvanna,2019,14021,13698,323
Virginia,Franklin,2019,26522,25742,780
Virginia,Franklin city,2019,3598,3453,145
Virginia,Frederick,2019,48459,47290,1169
Virginia,Fredericksburg city,2019,14282,13803,479
Virginia,Galax city,2019,2932,2836,96
Virginia,Giles,2019,7927,7669,258
Virginia,Gloucester,2019,19705,19198,507
Virginia,Goochland,2019,11302,10991,311
Virginia,Grayson,2019,8053,7819,234
Virginia,Greene,2019,10578,10331,247
Virginia,Greensville,2019,4307,4160,147
Virginia,Halifax,2019,15682,15066,616
Virginia,Hampton city,2019,64807,62353,2454
Virginia,Hanover,2019,59705,58264,1441
Virginia,Harrisonburg city,2019,25153,24345,808
Virginia,Henrico,2019,183486,178372,5114
Virginia,Henry,2019,23868,23069,799
Virginia,Highland,2019,1248,1214,34
Virginia,Hopewell city,2019,9757,9341,416
Virginia,Isle of Wight,2019,19570,19017,553
Virginia,James City,2019,36841,35860,981
Virginia,King and Queen,2019,3871,3763,108
Virginia,King George,2019,13515,13157,358
Virginia,King William,2019,9228,8976,252
Virginia,Lancaster,2019,5464,5230,234
Virginia,Lee,2019,8306,7967,339
Virginia,Lexington city,2019,2099,2001,98
Virginia,Loudoun,2019,224573,219414,5159
Virginia,Louisa,2019,20049,19517,532
Virginia,Lunenburg,2019,5338,5169,169
Virginia,Lynchburg city,2019,36598,35238,1360
Virginia,Madison,2019,7461,7295,166
Virginia,Manassas city,2019,22253,21696,557
Virginia,Manassas Park city,2019,9462,9228,234
Virginia,Martinsville city,2019,5501,5274,227
Virginia,Mathews,2019,4169,4048,121
Virginia,Mecklenburg,2019,12613,12105,508
Virginia,Middlesex,2019,5319,5181,138
Virginia,Montgomery,2019,50364,48937,1427
Virginia,Nelson,2019,7508,7300,208
Virginia,New Kent,2019,12577,12277,300
Virginia,Newport News city,2019,89406,86310,3096
Virginia,Norfolk city,2019,112364,108487,3877
Virginia,Northampton,2019,5485,5241,244
Virginia,Northumberland,2019,5704,5458,246
Virginia,Norton city,2019,1687,1625,62
Virginia,Nottoway,2019,7298,7095,203
Virginia,Orange,2019,17480,16961,519
Virginia,Page,2019,12065,11601,464
Virginia,Patrick,2019,7342,7084,258
Virginia,Petersburg city,2019,13129,12396,733
Virginia,Pittsylvania,2019,30210,29191,1019
Virginia,Poquoson city,2019,6427,6271,156
Virginia,Portsmouth city,2019,44566,42831,1735
Virginia,Powhatan,2019,14253,13892,361
Virginia,Prince Edward,2019,10444,10051,393
Virginia,Prince George,2019,15206,14695,511
Virginia,Prince William,2019,247826,241558,6268
Virginia,Pulaski,2019,16149,15594,555
Virginia,Radford city,2019,8688,8377,311
Virginia,Rappahannock,2019,3727,3633,94
Virginia,Richmond,2019,4097,3976,121
Virginia,Richmond city,2019,119265,115360,3905
Virginia,Roanoke,2019,49611,48349,1262
Virginia,Roanoke city,2019,49397,47900,1497
Virginia,Rockbridge,2019,10819,10523,296
Virginia,Rockingham,2019,42151,41146,1005
Virginia,Russell,2019,11227,10754,473
Virginia,Salem city,2019,13037,12677,360
Virginia,Scott,2019,9149,8863,286
Virginia,Shenandoah,2019,22426,21863,563
Virginia,Smyth,2019,13811,13296,515
Virginia,Southampton,2019,9139,8895,244
Virginia,Spotsylvania,2019,67663,65697,1966
Virginia,Stafford,2019,72712,70711,2001
Virginia,Staunton city,2019,12314,11986,328
Virginia,Suffolk city,2019,44928,43564,1364
Virginia,Surry,2019,3695,3568,127
Virginia,Sussex,2019,3833,3660,173
Virginia,Tazewell,2019,15748,15060,688
Virginia,Virginia Beach city,2019,234597,228266,6331
Virginia,Warren,2019,20611,20032,579
Virginia,Washington,2019,26806,25919,887
Virginia,Waynesboro city,2019,10762,10451,311
Virginia,Westmoreland,2019,9538,9204,334
Virginia,Williamsburg city,2019,6736,6475,261
Virginia,Winchester city,2019,14892,14480,412
Virginia,Wise,2019,13432,12809,623
Virginia,Wythe,2019,13776,13282,494
Virginia,York,2019,32989,32110,879
Washington,Adams,2019,9870,9312,558
Washington,Asotin,2019,10400,9969,431
Washington,Benton,2019,103169,97773,5396
Washington,Chelan,2019,45113,42911,2202
Washington,Clallam,2019,28886,26980,1906
Washington,Clark,2019,241901,230422,11479
Washington,Columbia,2019,1848,1747,101
Washington,Cowlitz,2019,47949,45086,2863
Washington,Douglas,2019,21968,20731,1237
Washington,Ferry,2019,2499,2216,283
Washington,Franklin,2019,43132,40383,2749
Washington,Garfield,2019,918,868,50
Washington,Grant,2019,46990,43751,3239
Washington,Grays Harbor,2019,29008,26961,2047
Washington,Island,2019,36116,34294,1822
Washington,Jefferson,2019,12938,12209,729
Washington,King,2019,1290480,1254638,35842
Washington,Kitsap,2019,128764,122887,5877
Washington,Kittitas,2019,23177,21905,1272
Washington,Klickitat,2019,10314,9712,602
Washington,Lewis,2019,34996,32841,2155
Washington,Lincoln,2019,5031,4779,252
Washington,Mason,2019,25325,23733,1592
Washington,Okanogan,2019,20346,18964,1382
Washington,Pacific,2019,8603,8007,596
Washington,Pend Oreille,2019,5074,4674,400
Washington,Pierce,2019,442094,419394,22700
Washington,San Juan,2019,8674,8349,325
Washington,Skagit,2019,63069,59644,3425
Washington,Skamania,2019,5555,5252,303
Washington,Snohomish,2019,439464,426100,13364
Washington,Spokane,2019,255027,241655,13372
Washington,Stevens,2019,19062,17726,1336
Washington,Thurston,2019,142896,135982,6914
Washington,Wahkiakum,2019,1375,1283,92
Washington,Walla Walla,2019,30252,28760,1492
Washington,Whatcom,2019,115413,109672,5741
Washington,Whitman,2019,23996,22958,1038
Washington,Yakima,2019,132466,123185,9281
West Virginia,Barbour,2019,7189,6760,429
West Virginia,Berkeley,2019,58635,56569,2066
West Virginia,Boone,2019,7443,7036,407
West Virginia,Braxton,2019,5245,4857,388
West Virginia,Brooke,2019,10013,9488,525
West Virginia,Cabell,2019,41620,39889,1731
West Virginia,Calhoun,2019,2558,2226,332
West Virginia,Clay,2019,3148,2879,269
West Virginia,Doddridge,2019,4011,3834,177
West Virginia,Fayette,2019,16286,15363,923
West Virginia,Gilmer,2019,2384,2221,163
West Virginia,Grant,2019,5959,5632,327
West Virginia,Greenbrier,2019,16005,15266,739
West Virginia,Hampshire,2019,10799,10384,415
West Virginia,Hancock,2019,13094,12418,676
West Virginia,Hardy,2019,5804,5507,297
West Virginia,Harrison,2019,34765,33229,1536
West Virginia,Jackson,2019,13478,12808,670
West Virginia,Jefferson,2019,30464,29527,937
West Virginia,Kanawha,2019,82440,78647,3793
West Virginia,Lewis,2019,6851,6428,423
West Virginia,Lincoln,2019,7213,6757,456
West Virginia,Logan,2019,11157,10492,665
West Virginia,Marion,2019,25621,24324,1297
West Virginia,Marshall,2019,14268,13366,902
West Virginia,Mason,2019,10227,9615,612
West Virginia,McDowell,2019,4451,4041,410
West Virginia,Mercer,2019,21036,19843,1193
West Virginia,Mineral,2019,12701,11980,721
West Virginia,Mingo,2019,6894,6422,472
West Virginia,Monongalia,2019,54746,52749,1997
West Virginia,Monroe,2019,5979,5718,261
West Virginia,Morgan,2019,8191,7874,317
West Virginia,Nicholas,2019,9521,8920,601
West Virginia,Ohio,2019,21367,20407,960
West Virginia,Pendleton,2019,3701,3559,142
West Virginia,Pleasants,2019,2924,2724,200
West Virginia,Pocahontas,2019,3891,3670,221
West Virginia,Preston,2019,15617,14904,713
West Virginia,Putnam,2019,26795,25630,1165
West Virginia,Raleigh,2019,30525,29093,1432
West Virginia,Randolph,2019,12352,11617,735
West Virginia,Ritchie,2019,4405,4156,249
West Virginia,Roane,2019,5145,4654,491
West Virginia,Summers,2019,4340,4102,238
West Virginia,Taylor,2019,7920,7537,383
West Virginia,Tucker,2019,3361,3186,175
West Virginia,Tyler,2019,3145,2900,245
West Virginia,Upshur,2019,9613,9040,573
West Virginia,Wayne,2019,15838,14983,855
West Virginia,Webster,2019,3326,3116,210
West Virginia,Wetzel,2019,6656,6174,482
West Virginia,Wirt,2019,2303,2122,181
West Virginia,Wood,2019,36845,34970,1875
West Virginia,Wyoming,2019,6706,6240,466
Wisconsin,Adams,2019,8153,7733,420
Wisconsin,Ashland,2019,7915,7536,379
Wisconsin,Barron,2019,24406,23428,978
Wisconsin,Bayfield,2019,7591,7165,426
Wisconsin,Brown,2019,141886,137489,4397
Wisconsin,Buffalo,2019,6466,6194,272
Wisconsin,Burnett,2019,7133,6752,381
Wisconsin,Calumet,2019,27565,26791,774
Wisconsin,Chippewa,2019,33181,31909,1272
Wisconsin,Clark,2019,17737,17151,586
Wisconsin,Columbia,2019,31587,30606,981
Wisconsin,Crawford,2019,7622,7297,325
Wisconsin,Dane,2019,321677,313824,7853
Wisconsin,Dodge,2019,47544,46107,1437
Wisconsin,Door,2019,15288,14706,582
Wisconsin,Douglas,2019,23029,22058,971
Wisconsin,Dunn,2019,24111,23257,854
Wisconsin,Eau Claire,2019,58872,57071,1801
Wisconsin,Florence,2019,2221,2115,106
Wisconsin,Forest,2019,4012,3803,209
Wisconsin,Grant,2019,27861,26962,899
Wisconsin,Green,2019,21049,20441,608
Wisconsin,Iowa,2019,13731,13334,397
Wisconsin,Iron,2019,2542,2388,154
Wisconsin,Jackson,2019,10276,9876,400
Wisconsin,Jefferson,2019,45857,44416,1441
Wisconsin,Juneau,2019,13446,12999,447
Wisconsin,Kenosha,2019,89403,85858,3545
Wisconsin,Kewaunee,2019,11042,10686,356
Wisconsin,La Crosse,2019,66318,64391,1927
Wisconsin,Lafayette,2019,10099,9829,270
Wisconsin,Langlade,2019,9321,8932,389
Wisconsin,Lincoln,2019,15071,14509,562
Wisconsin,Manitowoc,2019,40987,39589,1398
Wisconsin,Marathon,2019,73551,71419,2132
Wisconsin,Marinette,2019,19466,18573,893
Wisconsin,Marquette,2019,7714,7409,305
Wisconsin,Menominee,2019,1629,1498,131
Wisconsin,Milwaukee,2019,466908,448251,18657
Wisconsin,Monroe,2019,23377,22672,705
Wisconsin,Oconto,2019,20575,19830,745
Wisconsin,Oneida,2019,17846,17071,775
Wisconsin,Outagamie,2019,103135,100059,3076
Wisconsin,Ozaukee,2019,49030,47625,1405
Wisconsin,Pepin,2019,4147,3991,156
Wisconsin,Pierce,2019,25369,24504,865
Wisconsin,Polk,2019,24519,23519,1000
Wisconsin,Portage,2019,38592,37327,1265
Wisconsin,Price,2019,6493,6207,286
Wisconsin,Racine,2019,98585,94556,4029
Wisconsin,Richland,2019,9219,8926,293
Wisconsin,Rock,2019,85330,82147,3183
Wisconsin,Rusk,2019,6723,6393,330
Wisconsin,Sauk,2019,35576,34533,1043
Wisconsin,Sawyer,2019,7962,7582,380
Wisconsin,Shawano,2019,21024,20342,682
Wisconsin,Sheboygan,2019,62144,60436,1708
Wisconsin,St. Croix,2019,50446,48754,1692
Wisconsin,Taylor,2019,10973,10566,407
Wisconsin,Trempealeau,2019,15952,15374,578
Wisconsin,Vernon,2019,15278,14772,506
Wisconsin,Vilas,2019,10154,9721,433
Wisconsin,Walworth,2019,57872,55975,1897
Wisconsin,Washburn,2019,7858,7536,322
Wisconsin,Washington,2019,77161,74950,2211
Wisconsin,Waukesha,2019,224731,218151,6580
Wisconsin,Waupaca,2019,25943,25093,850
Wisconsin,Waushara,2019,11422,10955,467
Wisconsin,Winnebago,2019,91474,88728,2746
Wisconsin,Wood,2019,35136,33786,1350
Wyoming,Albany,2019,20216,19595,621
Wyoming,Big Horn,2019,5306,5083,223
Wyoming,Campbell,2019,23242,22389,853
Wyoming,Carbon,2019,7982,7720,262
Wyoming,Converse,2019,8694,8456,238
Wyoming,Crook,2019,3710,3593,117
Wyoming,Fremont,2019,18635,17811,824
Wyoming,Goshen,2019,6625,6387,238
Wyoming,Hot Springs,2019,2176,2099,77
Wyoming,Johnson,2019,4183,4032,151
Wyoming,Laramie,2019,48491,46813,1678
Wyoming,Lincoln,2019,8876,8581,295
Wyoming,Natrona,2019,39348,37804,1544
Wyoming,Niobrara,2019,1239,1205,34
Wyoming,Park,2019,15459,14839,620
Wyoming,Platte,2019,4660,4501,159
Wyoming,Sheridan,2019,15653,15111,542
Wyoming,Sublette,2019,4129,3947,182
Wyoming,Sweetwater,2019,21274,20446,828
Wyoming,Teton,2019,15575,15151,424
Wyoming,Uinta,2019,9035,8682,353
Wyoming,Washakie,2019,3941,3786,155
Wyoming,Weston,2019,3811,3701,110
#N/A,Adjuntas Municipio,2019,4115,3485,630
#N/A,Aguada Municipio,2019,11743,10553,1190
#N/A,Aguadilla Municipio,2019,14350,12881,1469
#N/A,Aguas Buenas Municipio,2019,6434,5846,588
#N/A,Aibonito Municipio,2019,6392,5722,670
#N/A,Anasco Municipio,2019,8706,7967,739
#N/A,Arecibo Municipio,2019,23668,21413,2255
#N/A,Arroyo Municipio,2019,4605,3985,620
#N/A,Barceloneta Municipio,2019,5827,5170,657
#N/A,Barranquitas Municipio,2019,7261,6627,634
#N/A,Bayamon Municipio,2019,64124,60109,4015
#N/A,Bear,ID,2019,2978,2891
#N/A,Cabo Rojo Municipio,2019,13373,12214,1159
#N/A,Caguas Municipio,2019,46941,43764,3177
#N/A,Camuy Municipio,2019,9402,8597,805
#N/A,Canovanas Municipio,2019,15767,14727,1040
#N/A,Carolina Municipio,2019,60399,56855,3544
#N/A,Catano Municipio,2019,7694,7140,554
#N/A,Cayey Municipio,2019,15836,14727,1109
#N/A,Ceiba Municipio,2019,3658,3278,380
#N/A,Ciales Municipio,2019,3651,3248,403
#N/A,Cidra Municipio,2019,15237,14195,1042
#N/A,Coamo Municipio,2019,9853,8647,1206
#N/A,Comerio Municipio,2019,4817,4389,428
#N/A,Corozal Municipio,2019,8806,8002,804
#N/A,Culebra Municipio,2019,893,866,27
#N/A,Dorado Municipio,2019,12937,12205,732
#N/A,Fajardo Municipio,2019,10804,9644,1160
#N/A,Florida Municipio,2019,3269,2914,355
#N/A,Fond du,WI,2019,57386,55701
#N/A,Golden,MT,2019,367,352
#N/A,Golden,ND,2019,830,815
#N/A,Green,WI,2019,9456,9086
#N/A,Guanica Municipio,2019,3947,3364,583
#N/A,Guayama Municipio,2019,10926,9605,1321
#N/A,Guayanilla Municipio,2019,5002,4311,691
#N/A,Guaynabo Municipio,2019,36917,35403,1514
#N/A,Gurabo Municipio,2019,17749,16741,1008
#N/A,Hatillo Municipio,2019,13427,11784,1643
#N/A,Hormigueros Municipio,2019,5303,4847,456
#N/A,Humacao Municipio,2019,16903,15193,1710
#N/A,Isabela Municipio,2019,12214,11108,1106
#N/A,Jayuya Municipio,2019,4206,3614,592
#N/A,Juana Diaz Municipio,2019,14844,13361,1483
#N/A,Juncos Municipio,2019,12067,11060,1007
#N/A,Lajas Municipio,2019,5136,4480,656
#N/A,Lares Municipio,2019,6900,5883,1017
#N/A,Las Marias Municipio,2019,2617,2313,304
#N/A,Las Piedras Municipio,2019,11103,10111,992
#N/A,Loiza Municipio,2019,8275,7645,630
#N/A,Luquillo Municipio,2019,6093,5512,581
#N/A,Manati Municipio,2019,11319,10417,902
#N/A,Maricao Municipio,2019,1895,1636,259
#N/A,Maunabo Municipio,2019,2902,2465,437
#N/A,Mayaguez Municipio,2019,21542,19278,2264
#N/A,Mille,MN,2019,13055,12347
#N/A,Moca Municipio,2019,10337,9257,1080
#N/A,Morovis Municipio,2019,7843,7127,716
#N/A,Naguabo Municipio,2019,8007,7297,710
#N/A,Naranjito Municipio,2019,6953,6364,589
#N/A,Oglala,SD,2019,3570,3222
#N/A,Orocovis Municipio,2019,4883,4379,504
#N/A,Patillas Municipio,2019,4276,3605,671
#N/A,Penuelas Municipio,2019,5830,5007,823
#N/A,Ponce Municipio,2019,44991,40634,4357
#N/A,Quebradillas Municipio,2019,5995,5297,698
#N/A,Red,MN,2019,2229,2111
#N/A,Rincon Municipio,2019,4693,4047,646
#N/A,Rio Grande Municipio,2019,16630,15414,1216
#N/A,Sabana Grande Municipio,2019,6064,5274,790
#N/A,Salinas Municipio,2019,7062,6041,1021
#N/A,Salt,UT,2019,634741,618767
#N/A,San German Municipio,2019,9585,8509,1076
#N/A,San Juan Municipio,2019,131645,124372,7273
#N/A,San Lorenzo Municipio,2019,11501,10490,1011
#N/A,San Sebastian Municipio,2019,10198,8807,1391
#N/A,Santa Isabel Municipio,2019,8717,7764,953
#N/A,St.,LA,2019,31891,29891
#N/A,St.,NY,2019,43294,40902
#N/A,Toa Alta Municipio,2019,26614,25106,1508
#N/A,Toa Baja Municipio,2019,28675,27023,1652
#N/A,Trujillo Alto Municipio,2019,26569,25281,1288
#N/A,Utuado Municipio,2019,6588,5841,747
#N/A,Vega Alta Municipio,2019,9554,8778,776
#N/A,Vega Baja Municipio,2019,13037,11791,1246
#N/A,Vieques Municipio,2019,2585,2406,179
#N/A,Villalba Municipio,2019,7406,6231,1175
#N/A,Yabucoa Municipio,2019,8691,7552,1139
#N/A,Yauco Municipio,2019,9759,8331,1428
